PERIOD,Hospital trust name,CANCER TYPE,TOTAL PATIENTS,Informed within 28-days,Informed over 28-days
Apr-22,ROYAL SURREY COUNTY HOSPITAL NHS FOUNDATION TRUST,Suspected breast cancer,159,149,10
Apr-22,SURREY AND SUSSEX HEALTHCARE NHS TRUST,Suspected breast cancer,283,212,71
Apr-22,FRIMLEY HEALTH NHS FOUNDATION TRUST,Suspected breast cancer,387,317,70
Apr-22,UNIVERSITY HOSPITALS SUSSEX NHS FOUNDATION TRUST,Suspected breast cancer,628,525,103
Apr-22,ASHFORD AND ST PETER'S HOSPITALS NHS FOUNDATION TRUST,Suspected breast cancer,175,166,9
Apr-22,EAST SUSSEX HEALTHCARE NHS TRUST,Suspected breast cancer,253,126,127
Apr-22,FRIMLEY HEALTH NHS FOUNDATION TRUST,Suspected gynaecological cancer,132,74,58
Apr-22,EAST SUSSEX HEALTHCARE NHS TRUST,Suspected gynaecological cancer,152,91,61
Apr-22,ROYAL SURREY COUNTY HOSPITAL NHS FOUNDATION TRUST,Suspected gynaecological cancer,60,47,13
Apr-22,ASHFORD AND ST PETER'S HOSPITALS NHS FOUNDATION TRUST,Suspected gynaecological cancer,84,54,30
Apr-22,ROYAL SURREY COUNTY HOSPITAL NHS FOUNDATION TRUST,Suspected head & neck cancer,81,77,4
Apr-22,SURREY AND SUSSEX HEALTHCARE NHS TRUST,Suspected gynaecological cancer,220,158,62
Apr-22,UNIVERSITY HOSPITALS SUSSEX NHS FOUNDATION TRUST,Suspected gynaecological cancer,277,182,95
Apr-22,ASHFORD AND ST PETER'S HOSPITALS NHS FOUNDATION TRUST,Suspected head & neck cancer,99,77,22
Apr-22,FRIMLEY HEALTH NHS FOUNDATION TRUST,Suspected head & neck cancer,204,153,51
Apr-22,QUEEN VICTORIA HOSPITAL NHS FOUNDATION TRUST,Suspected head & neck cancer,236,197,39
Apr-22,ROYAL SURREY COUNTY HOSPITAL NHS FOUNDATION TRUST,Suspected lower gastrointestinal cancer,161,118,43
Apr-22,UNIVERSITY HOSPITALS SUSSEX NHS FOUNDATION TRUST,Suspected lower gastrointestinal cancer,799,432,367
Apr-22,SURREY AND SUSSEX HEALTHCARE NHS TRUST,Suspected lower gastrointestinal cancer,341,194,147
Apr-22,EAST SUSSEX HEALTHCARE NHS TRUST,Suspected head & neck cancer,166,119,47
Apr-22,UNIVERSITY HOSPITALS SUSSEX NHS FOUNDATION TRUST,Suspected head & neck cancer,282,201,81
Apr-22,SURREY AND SUSSEX HEALTHCARE NHS TRUST,Suspected head & neck cancer,107,84,23
Apr-22,ASHFORD AND ST PETER'S HOSPITALS NHS FOUNDATION TRUST,Suspected lower gastrointestinal cancer,300,214,86
Apr-22,EAST SUSSEX HEALTHCARE NHS TRUST,Suspected lower gastrointestinal cancer,347,239,108
Apr-22,FRIMLEY HEALTH NHS FOUNDATION TRUST,Suspected lower gastrointestinal cancer,410,161,249
Apr-22,ROYAL SURREY COUNTY HOSPITAL NHS FOUNDATION TRUST,Suspected lung cancer,11,10,1
Apr-22,SURREY AND SUSSEX HEALTHCARE NHS TRUST,Suspected lung cancer,52,47,5
Apr-22,ASHFORD AND ST PETER'S HOSPITALS NHS FOUNDATION TRUST,Suspected lung cancer,21,13,8
Apr-22,FRIMLEY HEALTH NHS FOUNDATION TRUST,Suspected lung cancer,63,46,17
Apr-22,EAST SUSSEX HEALTHCARE NHS TRUST,Suspected lung cancer,42,27,15
Apr-22,UNIVERSITY HOSPITALS SUSSEX NHS FOUNDATION TRUST,Suspected lung cancer,58,44,14
Apr-22,QUEEN VICTORIA HOSPITAL NHS FOUNDATION TRUST,Suspected skin cancer,200,162,38
Apr-22,ROYAL SURREY COUNTY HOSPITAL NHS FOUNDATION TRUST,Suspected skin cancer,6,6,0
Apr-22,EAST SUSSEX HEALTHCARE NHS TRUST,Suspected skin cancer,337,312,25
Apr-22,SURREY AND SUSSEX HEALTHCARE NHS TRUST,Suspected skin cancer,441,420,21
Apr-22,ASHFORD AND ST PETER'S HOSPITALS NHS FOUNDATION TRUST,Suspected skin cancer,316,302,14
Apr-22,FRIMLEY HEALTH NHS FOUNDATION TRUST,Suspected skin cancer,451,433,18
Apr-22,UNIVERSITY HOSPITALS SUSSEX NHS FOUNDATION TRUST,Suspected skin cancer,823,730,93
Apr-22,SURREY AND SUSSEX HEALTHCARE NHS TRUST,Suspected upper gastrointestinal cancer,133,107,26
Apr-22,FRIMLEY HEALTH NHS FOUNDATION TRUST,Suspected upper gastrointestinal cancer,143,103,40
Apr-22,ASHFORD AND ST PETER'S HOSPITALS NHS FOUNDATION TRUST,Suspected urological malignancies (excluding testicular),76,52,24
Apr-22,ASHFORD AND ST PETER'S HOSPITALS NHS FOUNDATION TRUST,Suspected upper gastrointestinal cancer,113,49,64
Apr-22,ROYAL SURREY COUNTY HOSPITAL NHS FOUNDATION TRUST,Suspected upper gastrointestinal cancer,50,48,2
Apr-22,EAST SUSSEX HEALTHCARE NHS TRUST,Suspected upper gastrointestinal cancer,129,99,30
Apr-22,FRIMLEY HEALTH NHS FOUNDATION TRUST,Suspected urological malignancies (excluding testicular),152,107,45
Apr-22,UNIVERSITY HOSPITALS SUSSEX NHS FOUNDATION TRUST,Suspected upper gastrointestinal cancer,222,139,83
Apr-22,UNIVERSITY HOSPITALS SUSSEX NHS FOUNDATION TRUST,Suspected urological malignancies (excluding testicular),347,146,201
Apr-22,ROYAL SURREY COUNTY HOSPITAL NHS FOUNDATION TRUST,Suspected urological malignancies (excluding testicular),82,65,17
Apr-22,SURREY AND SUSSEX HEALTHCARE NHS TRUST,Suspected urological malignancies (excluding testicular),164,116,48
Apr-22,EAST SUSSEX HEALTHCARE NHS TRUST,Suspected urological malignancies (excluding testicular),225,163,62
May-22,ROYAL SURREY COUNTY HOSPITAL NHS FOUNDATION TRUST,Suspected breast cancer,146,142,4
May-22,FRIMLEY HEALTH NHS FOUNDATION TRUST,Suspected breast cancer,377,282,95
May-22,UNIVERSITY HOSPITALS SUSSEX NHS FOUNDATION TRUST,Suspected breast cancer,657,597,60
May-22,SURREY AND SUSSEX HEALTHCARE NHS TRUST,Suspected breast cancer,322,256,66
May-22,EAST SUSSEX HEALTHCARE NHS TRUST,Suspected breast cancer,261,122,139
May-22,ASHFORD AND ST PETER'S HOSPITALS NHS FOUNDATION TRUST,Suspected breast cancer,211,187,24
May-22,ROYAL SURREY COUNTY HOSPITAL NHS FOUNDATION TRUST,Suspected gynaecological cancer,40,27,13
May-22,ASHFORD AND ST PETER'S HOSPITALS NHS FOUNDATION TRUST,Suspected gynaecological cancer,133,79,54
May-22,FRIMLEY HEALTH NHS FOUNDATION TRUST,Suspected gynaecological cancer,137,84,53
May-22,SURREY AND SUSSEX HEALTHCARE NHS TRUST,Suspected gynaecological cancer,193,144,49
May-22,EAST SUSSEX HEALTHCARE NHS TRUST,Suspected gynaecological cancer,174,126,48
May-22,UNIVERSITY HOSPITALS SUSSEX NHS FOUNDATION TRUST,Suspected gynaecological cancer,373,173,200
May-22,ROYAL SURREY COUNTY HOSPITAL NHS FOUNDATION TRUST,Suspected head & neck cancer,117,112,5
May-22,FRIMLEY HEALTH NHS FOUNDATION TRUST,Suspected head & neck cancer,238,175,63
May-22,QUEEN VICTORIA HOSPITAL NHS FOUNDATION TRUST,Suspected head & neck cancer,272,239,33
May-22,ASHFORD AND ST PETER'S HOSPITALS NHS FOUNDATION TRUST,Suspected head & neck cancer,137,103,34
May-22,ROYAL SURREY COUNTY HOSPITAL NHS FOUNDATION TRUST,Suspected lower gastrointestinal cancer,182,127,55
May-22,FRIMLEY HEALTH NHS FOUNDATION TRUST,Suspected lower gastrointestinal cancer,510,250,260
May-22,EAST SUSSEX HEALTHCARE NHS TRUST,Suspected head & neck cancer,194,127,67
May-22,UNIVERSITY HOSPITALS SUSSEX NHS FOUNDATION TRUST,Suspected head & neck cancer,375,257,118
May-22,SURREY AND SUSSEX HEALTHCARE NHS TRUST,Suspected head & neck cancer,118,87,31
May-22,UNIVERSITY HOSPITALS SUSSEX NHS FOUNDATION TRUST,Suspected lower gastrointestinal cancer,764,405,359
May-22,SURREY AND SUSSEX HEALTHCARE NHS TRUST,Suspected lower gastrointestinal cancer,444,314,130
May-22,ASHFORD AND ST PETER'S HOSPITALS NHS FOUNDATION TRUST,Suspected lung cancer,26,13,13
May-22,ROYAL SURREY COUNTY HOSPITAL NHS FOUNDATION TRUST,Suspected skin cancer,8,8,0
May-22,EAST SUSSEX HEALTHCARE NHS TRUST,Suspected lung cancer,44,31,13
May-22,FRIMLEY HEALTH NHS FOUNDATION TRUST,Suspected lung cancer,57,47,10
May-22,ASHFORD AND ST PETER'S HOSPITALS NHS FOUNDATION TRUST,Suspected lower gastrointestinal cancer,316,225,91
May-22,UNIVERSITY HOSPITALS SUSSEX NHS FOUNDATION TRUST,Suspected lung cancer,52,41,11
May-22,ROYAL SURREY COUNTY HOSPITAL NHS FOUNDATION TRUST,Suspected lung cancer,23,19,4
May-22,EAST SUSSEX HEALTHCARE NHS TRUST,Suspected lower gastrointestinal cancer,405,247,158
May-22,UNIVERSITY HOSPITALS SUSSEX NHS FOUNDATION TRUST,Suspected skin cancer,1043,875,168
May-22,FRIMLEY HEALTH NHS FOUNDATION TRUST,Suspected skin cancer,560,545,15
May-22,SURREY AND SUSSEX HEALTHCARE NHS TRUST,Suspected lung cancer,53,43,10
May-22,SURREY AND SUSSEX HEALTHCARE NHS TRUST,Suspected skin cancer,447,421,26
May-22,QUEEN VICTORIA HOSPITAL NHS FOUNDATION TRUST,Suspected skin cancer,218,181,37
May-22,EAST SUSSEX HEALTHCARE NHS TRUST,Suspected skin cancer,444,415,29
May-22,SURREY AND SUSSEX HEALTHCARE NHS TRUST,Suspected upper gastrointestinal cancer,172,137,35
May-22,ASHFORD AND ST PETER'S HOSPITALS NHS FOUNDATION TRUST,Suspected skin cancer,354,330,24
May-22,UNIVERSITY HOSPITALS SUSSEX NHS FOUNDATION TRUST,Suspected upper gastrointestinal cancer,274,185,89
May-22,ROYAL SURREY COUNTY HOSPITAL NHS FOUNDATION TRUST,Suspected upper gastrointestinal cancer,43,40,3
May-22,FRIMLEY HEALTH NHS FOUNDATION TRUST,Suspected upper gastrointestinal cancer,145,113,32
May-22,ASHFORD AND ST PETER'S HOSPITALS NHS FOUNDATION TRUST,Suspected upper gastrointestinal cancer,117,44,73
May-22,FRIMLEY HEALTH NHS FOUNDATION TRUST,Suspected urological malignancies (excluding testicular),218,126,92
May-22,ROYAL SURREY COUNTY HOSPITAL NHS FOUNDATION TRUST,Suspected urological malignancies (excluding testicular),69,63,6
May-22,EAST SUSSEX HEALTHCARE NHS TRUST,Suspected urological malignancies (excluding testicular),196,130,66
May-22,UNIVERSITY HOSPITALS SUSSEX NHS FOUNDATION TRUST,Suspected urological malignancies (excluding testicular),475,170,305
May-22,EAST SUSSEX HEALTHCARE NHS TRUST,Suspected upper gastrointestinal cancer,121,92,29
May-22,SURREY AND SUSSEX HEALTHCARE NHS TRUST,Suspected urological malignancies (excluding testicular),175,103,72
May-22,ASHFORD AND ST PETER'S HOSPITALS NHS FOUNDATION TRUST,Suspected urological malignancies (excluding testicular),115,68,47
Jun-22,ROYAL SURREY COUNTY HOSPITAL NHS FOUNDATION TRUST,Suspected breast cancer,131,122,9
Jun-22,FRIMLEY HEALTH NHS FOUNDATION TRUST,Suspected breast cancer,310,194,116
Jun-22,SURREY AND SUSSEX HEALTHCARE NHS TRUST,Suspected breast cancer,265,218,47
Jun-22,ASHFORD AND ST PETER'S HOSPITALS NHS FOUNDATION TRUST,Suspected breast cancer,151,138,13
Jun-22,UNIVERSITY HOSPITALS SUSSEX NHS FOUNDATION TRUST,Suspected breast cancer,536,466,70
Jun-22,EAST SUSSEX HEALTHCARE NHS TRUST,Suspected breast cancer,275,96,179
Jun-22,FRIMLEY HEALTH NHS FOUNDATION TRUST,Suspected gynaecological cancer,161,72,89
Jun-22,ROYAL SURREY COUNTY HOSPITAL NHS FOUNDATION TRUST,Suspected gynaecological cancer,49,33,16
Jun-22,SURREY AND SUSSEX HEALTHCARE NHS TRUST,Suspected gynaecological cancer,184,107,77
Jun-22,ASHFORD AND ST PETER'S HOSPITALS NHS FOUNDATION TRUST,Suspected gynaecological cancer,80,50,30
Jun-22,UNIVERSITY HOSPITALS SUSSEX NHS FOUNDATION TRUST,Suspected gynaecological cancer,396,165,231
Jun-22,EAST SUSSEX HEALTHCARE NHS TRUST,Suspected gynaecological cancer,169,124,45
Jun-22,FRIMLEY HEALTH NHS FOUNDATION TRUST,Suspected head & neck cancer,199,151,48
Jun-22,ROYAL SURREY COUNTY HOSPITAL NHS FOUNDATION TRUST,Suspected head & neck cancer,134,125,9
Jun-22,ROYAL SURREY COUNTY HOSPITAL NHS FOUNDATION TRUST,Suspected lower gastrointestinal cancer,274,159,115
Jun-22,ASHFORD AND ST PETER'S HOSPITALS NHS FOUNDATION TRUST,Suspected head & neck cancer,110,75,35
Jun-22,UNIVERSITY HOSPITALS SUSSEX NHS FOUNDATION TRUST,Suspected head & neck cancer,328,223,105
Jun-22,SURREY AND SUSSEX HEALTHCARE NHS TRUST,Suspected lower gastrointestinal cancer,422,323,99
Jun-22,QUEEN VICTORIA HOSPITAL NHS FOUNDATION TRUST,Suspected head & neck cancer,198,181,17
Jun-22,EAST SUSSEX HEALTHCARE NHS TRUST,Suspected lower gastrointestinal cancer,412,264,148
Jun-22,FRIMLEY HEALTH NHS FOUNDATION TRUST,Suspected lower gastrointestinal cancer,298,115,183
Jun-22,ASHFORD AND ST PETER'S HOSPITALS NHS FOUNDATION TRUST,Suspected lower gastrointestinal cancer,360,240,120
Jun-22,ROYAL SURREY COUNTY HOSPITAL NHS FOUNDATION TRUST,Suspected lung cancer,17,12,5
Jun-22,SURREY AND SUSSEX HEALTHCARE NHS TRUST,Suspected head & neck cancer,105,76,29
Jun-22,UNIVERSITY HOSPITALS SUSSEX NHS FOUNDATION TRUST,Suspected lower gastrointestinal cancer,788,413,375
Jun-22,FRIMLEY HEALTH NHS FOUNDATION TRUST,Suspected lung cancer,44,33,11
Jun-22,EAST SUSSEX HEALTHCARE NHS TRUST,Suspected head & neck cancer,202,123,79
Jun-22,UNIVERSITY HOSPITALS SUSSEX NHS FOUNDATION TRUST,Suspected lung cancer,60,46,14
Jun-22,ROYAL SURREY COUNTY HOSPITAL NHS FOUNDATION TRUST,Suspected skin cancer,13,9,4
Jun-22,EAST SUSSEX HEALTHCARE NHS TRUST,Suspected lung cancer,51,38,13
Jun-22,EAST SUSSEX HEALTHCARE NHS TRUST,Suspected skin cancer,537,491,46
Jun-22,ASHFORD AND ST PETER'S HOSPITALS NHS FOUNDATION TRUST,Suspected lung cancer,21,16,5
Jun-22,SURREY AND SUSSEX HEALTHCARE NHS TRUST,Suspected lung cancer,42,34,8
Jun-22,ASHFORD AND ST PETER'S HOSPITALS NHS FOUNDATION TRUST,Suspected skin cancer,397,364,33
Jun-22,QUEEN VICTORIA HOSPITAL NHS FOUNDATION TRUST,Suspected skin cancer,250,202,48
Jun-22,SURREY AND SUSSEX HEALTHCARE NHS TRUST,Suspected skin cancer,421,397,24
Jun-22,UNIVERSITY HOSPITALS SUSSEX NHS FOUNDATION TRUST,Suspected skin cancer,982,863,119
Jun-22,FRIMLEY HEALTH NHS FOUNDATION TRUST,Suspected skin cancer,452,438,14
Jun-22,EAST SUSSEX HEALTHCARE NHS TRUST,Suspected upper gastrointestinal cancer,169,129,40
Jun-22,ROYAL SURREY COUNTY HOSPITAL NHS FOUNDATION TRUST,Suspected upper gastrointestinal cancer,42,33,9
Jun-22,FRIMLEY HEALTH NHS FOUNDATION TRUST,Suspected urological malignancies (excluding testicular),156,104,52
Jun-22,FRIMLEY HEALTH NHS FOUNDATION TRUST,Suspected upper gastrointestinal cancer,87,65,22
Jun-22,SURREY AND SUSSEX HEALTHCARE NHS TRUST,Suspected upper gastrointestinal cancer,134,109,25
Jun-22,EAST SUSSEX HEALTHCARE NHS TRUST,Suspected urological malignancies (excluding testicular),203,135,68
Jun-22,ASHFORD AND ST PETER'S HOSPITALS NHS FOUNDATION TRUST,Suspected urological malignancies (excluding testicular),118,70,48
Jun-22,SURREY AND SUSSEX HEALTHCARE NHS TRUST,Suspected urological malignancies (excluding testicular),142,98,44
Jun-22,ASHFORD AND ST PETER'S HOSPITALS NHS FOUNDATION TRUST,Suspected upper gastrointestinal cancer,98,44,54
Jun-22,UNIVERSITY HOSPITALS SUSSEX NHS FOUNDATION TRUST,Suspected upper gastrointestinal cancer,277,182,95
Jun-22,ROYAL SURREY COUNTY HOSPITAL NHS FOUNDATION TRUST,Suspected urological malignancies (excluding testicular),70,58,12
Jun-22,UNIVERSITY HOSPITALS SUSSEX NHS FOUNDATION TRUST,Suspected urological malignancies (excluding testicular),470,168,302
Jul-22,FRIMLEY HEALTH NHS FOUNDATION TRUST,Suspected breast cancer,403,250,153
Jul-22,ROYAL SURREY COUNTY HOSPITAL NHS FOUNDATION TRUST,Suspected breast cancer,119,115,4
Jul-22,ASHFORD AND ST PETER'S HOSPITALS NHS FOUNDATION TRUST,Suspected breast cancer,158,144,14
Jul-22,SURREY AND SUSSEX HEALTHCARE NHS TRUST,Suspected breast cancer,307,239,68
Jul-22,EAST SUSSEX HEALTHCARE NHS TRUST,Suspected breast cancer,257,136,121
Jul-22,UNIVERSITY HOSPITALS SUSSEX NHS FOUNDATION TRUST,Suspected breast cancer,495,385,110
Jul-22,ROYAL SURREY COUNTY HOSPITAL NHS FOUNDATION TRUST,Suspected gynaecological cancer,31,23,8
Jul-22,EAST SUSSEX HEALTHCARE NHS TRUST,Suspected gynaecological cancer,193,122,71
Jul-22,UNIVERSITY HOSPITALS SUSSEX NHS FOUNDATION TRUST,Suspected gynaecological cancer,353,148,205
Jul-22,ASHFORD AND ST PETER'S HOSPITALS NHS FOUNDATION TRUST,Suspected gynaecological cancer,137,99,38
Jul-22,FRIMLEY HEALTH NHS FOUNDATION TRUST,Suspected gynaecological cancer,166,77,89
Jul-22,SURREY AND SUSSEX HEALTHCARE NHS TRUST,Suspected gynaecological cancer,164,101,63
Jul-22,QUEEN VICTORIA HOSPITAL NHS FOUNDATION TRUST,Suspected head & neck cancer,205,172,33
Jul-22,ASHFORD AND ST PETER'S HOSPITALS NHS FOUNDATION TRUST,Suspected head & neck cancer,113,94,19
Jul-22,ASHFORD AND ST PETER'S HOSPITALS NHS FOUNDATION TRUST,Suspected lower gastrointestinal cancer,431,300,131
Jul-22,SURREY AND SUSSEX HEALTHCARE NHS TRUST,Suspected lower gastrointestinal cancer,331,256,75
Jul-22,EAST SUSSEX HEALTHCARE NHS TRUST,Suspected head & neck cancer,262,191,71
Jul-22,FRIMLEY HEALTH NHS FOUNDATION TRUST,Suspected lower gastrointestinal cancer,334,92,242
Jul-22,UNIVERSITY HOSPITALS SUSSEX NHS FOUNDATION TRUST,Suspected head & neck cancer,357,247,110
Jul-22,ROYAL SURREY COUNTY HOSPITAL NHS FOUNDATION TRUST,Suspected head & neck cancer,128,123,5
Jul-22,ROYAL SURREY COUNTY HOSPITAL NHS FOUNDATION TRUST,Suspected lower gastrointestinal cancer,255,196,59
Jul-22,EAST SUSSEX HEALTHCARE NHS TRUST,Suspected lower gastrointestinal cancer,464,302,162
Jul-22,FRIMLEY HEALTH NHS FOUNDATION TRUST,Suspected head & neck cancer,157,120,37
Jul-22,UNIVERSITY HOSPITALS SUSSEX NHS FOUNDATION TRUST,Suspected lower gastrointestinal cancer,767,391,376
Jul-22,ROYAL SURREY COUNTY HOSPITAL NHS FOUNDATION TRUST,Suspected lung cancer,15,8,7
Jul-22,SURREY AND SUSSEX HEALTHCARE NHS TRUST,Suspected head & neck cancer,110,88,22
Jul-22,FRIMLEY HEALTH NHS FOUNDATION TRUST,Suspected lung cancer,45,34,11
Jul-22,ASHFORD AND ST PETER'S HOSPITALS NHS FOUNDATION TRUST,Suspected lung cancer,19,12,7
Jul-22,SURREY AND SUSSEX HEALTHCARE NHS TRUST,Suspected lung cancer,51,49,2
Jul-22,UNIVERSITY HOSPITALS SUSSEX NHS FOUNDATION TRUST,Suspected lung cancer,83,68,15
Jul-22,SURREY AND SUSSEX HEALTHCARE NHS TRUST,Suspected skin cancer,479,455,24
Jul-22,EAST SUSSEX HEALTHCARE NHS TRUST,Suspected lung cancer,38,29,9
Jul-22,EAST SUSSEX HEALTHCARE NHS TRUST,Suspected skin cancer,528,482,46
Jul-22,ROYAL SURREY COUNTY HOSPITAL NHS FOUNDATION TRUST,Suspected skin cancer,19,16,3
Jul-22,FRIMLEY HEALTH NHS FOUNDATION TRUST,Suspected skin cancer,569,541,28
Jul-22,ROYAL SURREY COUNTY HOSPITAL NHS FOUNDATION TRUST,Suspected upper gastrointestinal cancer,38,30,8
Jul-22,ASHFORD AND ST PETER'S HOSPITALS NHS FOUNDATION TRUST,Suspected upper gastrointestinal cancer,86,52,34
Jul-22,ASHFORD AND ST PETER'S HOSPITALS NHS FOUNDATION TRUST,Suspected skin cancer,421,325,96
Jul-22,FRIMLEY HEALTH NHS FOUNDATION TRUST,Suspected upper gastrointestinal cancer,130,103,27
Jul-22,UNIVERSITY HOSPITALS SUSSEX NHS FOUNDATION TRUST,Suspected skin cancer,1036,944,92
Jul-22,EAST SUSSEX HEALTHCARE NHS TRUST,Suspected upper gastrointestinal cancer,120,89,31
Jul-22,ROYAL SURREY COUNTY HOSPITAL NHS FOUNDATION TRUST,Suspected urological malignancies (excluding testicular),87,82,5
Jul-22,UNIVERSITY HOSPITALS SUSSEX NHS FOUNDATION TRUST,Suspected upper gastrointestinal cancer,299,222,77
Jul-22,QUEEN VICTORIA HOSPITAL NHS FOUNDATION TRUST,Suspected skin cancer,234,202,32
Jul-22,FRIMLEY HEALTH NHS FOUNDATION TRUST,Suspected urological malignancies (excluding testicular),186,105,81
Jul-22,SURREY AND SUSSEX HEALTHCARE NHS TRUST,Suspected upper gastrointestinal cancer,146,120,26
Jul-22,UNIVERSITY HOSPITALS SUSSEX NHS FOUNDATION TRUST,Suspected urological malignancies (excluding testicular),411,172,239
Jul-22,EAST SUSSEX HEALTHCARE NHS TRUST,Suspected urological malignancies (excluding testicular),174,125,49
Jul-22,ASHFORD AND ST PETER'S HOSPITALS NHS FOUNDATION TRUST,Suspected urological malignancies (excluding testicular),103,70,33
Jul-22,SURREY AND SUSSEX HEALTHCARE NHS TRUST,Suspected urological malignancies (excluding testicular),129,96,33
Aug-22,ROYAL SURREY COUNTY HOSPITAL NHS FOUNDATION TRUST,Suspected breast cancer,193,185,8
Aug-22,FRIMLEY HEALTH NHS FOUNDATION TRUST,Suspected breast cancer,530,348,182
Aug-22,UNIVERSITY HOSPITALS SUSSEX NHS FOUNDATION TRUST,Suspected breast cancer,690,514,176
Aug-22,ASHFORD AND ST PETER'S HOSPITALS NHS FOUNDATION TRUST,Suspected breast cancer,183,154,29
Aug-22,SURREY AND SUSSEX HEALTHCARE NHS TRUST,Suspected breast cancer,275,182,93
Aug-22,EAST SUSSEX HEALTHCARE NHS TRUST,Suspected breast cancer,301,190,111
Aug-22,ROYAL SURREY COUNTY HOSPITAL NHS FOUNDATION TRUST,Suspected gynaecological cancer,48,30,18
Aug-22,SURREY AND SUSSEX HEALTHCARE NHS TRUST,Suspected gynaecological cancer,198,112,86
Aug-22,UNIVERSITY HOSPITALS SUSSEX NHS FOUNDATION TRUST,Suspected gynaecological cancer,372,135,237
Aug-22,EAST SUSSEX HEALTHCARE NHS TRUST,Suspected gynaecological cancer,205,136,69
Aug-22,FRIMLEY HEALTH NHS FOUNDATION TRUST,Suspected gynaecological cancer,191,110,81
Aug-22,ASHFORD AND ST PETER'S HOSPITALS NHS FOUNDATION TRUST,Suspected gynaecological cancer,124,79,45
Aug-22,ROYAL SURREY COUNTY HOSPITAL NHS FOUNDATION TRUST,Suspected head & neck cancer,98,85,13
Aug-22,FRIMLEY HEALTH NHS FOUNDATION TRUST,Suspected head & neck cancer,191,154,37
Aug-22,ASHFORD AND ST PETER'S HOSPITALS NHS FOUNDATION TRUST,Suspected head & neck cancer,139,114,25
Aug-22,EAST SUSSEX HEALTHCARE NHS TRUST,Suspected head & neck cancer,181,136,45
Aug-22,QUEEN VICTORIA HOSPITAL NHS FOUNDATION TRUST,Suspected head & neck cancer,222,195,27
Aug-22,SURREY AND SUSSEX HEALTHCARE NHS TRUST,Suspected head & neck cancer,110,77,33
Aug-22,FRIMLEY HEALTH NHS FOUNDATION TRUST,Suspected lower gastrointestinal cancer,392,148,244
Aug-22,FRIMLEY HEALTH NHS FOUNDATION TRUST,Suspected lung cancer,71,48,23
Aug-22,UNIVERSITY HOSPITALS SUSSEX NHS FOUNDATION TRUST,Suspected head & neck cancer,361,272,89
Aug-22,ASHFORD AND ST PETER'S HOSPITALS NHS FOUNDATION TRUST,Suspected lower gastrointestinal cancer,512,335,177
Aug-22,UNIVERSITY HOSPITALS SUSSEX NHS FOUNDATION TRUST,Suspected lower gastrointestinal cancer,869,321,548
Aug-22,SURREY AND SUSSEX HEALTHCARE NHS TRUST,Suspected lung cancer,48,36,12
Aug-22,ROYAL SURREY COUNTY HOSPITAL NHS FOUNDATION TRUST,Suspected lower gastrointestinal cancer,301,233,68
Aug-22,ASHFORD AND ST PETER'S HOSPITALS NHS FOUNDATION TRUST,Suspected lung cancer,24,13,11
Aug-22,SURREY AND SUSSEX HEALTHCARE NHS TRUST,Suspected lower gastrointestinal cancer,347,132,215
Aug-22,EAST SUSSEX HEALTHCARE NHS TRUST,Suspected lower gastrointestinal cancer,503,255,248
Aug-22,ROYAL SURREY COUNTY HOSPITAL NHS FOUNDATION TRUST,Suspected lung cancer,18,13,5
Aug-22,QUEEN VICTORIA HOSPITAL NHS FOUNDATION TRUST,Suspected skin cancer,226,191,35
Aug-22,EAST SUSSEX HEALTHCARE NHS TRUST,Suspected lung cancer,27,15,12
Aug-22,UNIVERSITY HOSPITALS SUSSEX NHS FOUNDATION TRUST,Suspected lung cancer,77,66,11
Aug-22,ASHFORD AND ST PETER'S HOSPITALS NHS FOUNDATION TRUST,Suspected skin cancer,548,472,76
Aug-22,SURREY AND SUSSEX HEALTHCARE NHS TRUST,Suspected skin cancer,645,613,32
Aug-22,UNIVERSITY HOSPITALS SUSSEX NHS FOUNDATION TRUST,Suspected skin cancer,1170,1052,118
Aug-22,ROYAL SURREY COUNTY HOSPITAL NHS FOUNDATION TRUST,Suspected skin cancer,28,22,6
Aug-22,FRIMLEY HEALTH NHS FOUNDATION TRUST,Suspected skin cancer,595,528,67
Aug-22,UNIVERSITY HOSPITALS SUSSEX NHS FOUNDATION TRUST,Suspected upper gastrointestinal cancer,292,180,112
Aug-22,EAST SUSSEX HEALTHCARE NHS TRUST,Suspected upper gastrointestinal cancer,153,113,40
Aug-22,EAST SUSSEX HEALTHCARE NHS TRUST,Suspected skin cancer,396,358,38
Aug-22,FRIMLEY HEALTH NHS FOUNDATION TRUST,Suspected urological malignancies (excluding testicular),183,112,71
Aug-22,EAST SUSSEX HEALTHCARE NHS TRUST,Suspected urological malignancies (excluding testicular),167,125,42
Aug-22,ASHFORD AND ST PETER'S HOSPITALS NHS FOUNDATION TRUST,Suspected urological malignancies (excluding testicular),124,93,31
Aug-22,UNIVERSITY HOSPITALS SUSSEX NHS FOUNDATION TRUST,Suspected urological malignancies (excluding testicular),452,224,228
Aug-22,SURREY AND SUSSEX HEALTHCARE NHS TRUST,Suspected upper gastrointestinal cancer,161,127,34
Aug-22,ASHFORD AND ST PETER'S HOSPITALS NHS FOUNDATION TRUST,Suspected upper gastrointestinal cancer,91,55,36
Aug-22,ROYAL SURREY COUNTY HOSPITAL NHS FOUNDATION TRUST,Suspected upper gastrointestinal cancer,81,60,21
Aug-22,FRIMLEY HEALTH NHS FOUNDATION TRUST,Suspected upper gastrointestinal cancer,151,115,36
Aug-22,ROYAL SURREY COUNTY HOSPITAL NHS FOUNDATION TRUST,Suspected urological malignancies (excluding testicular),76,62,14
Aug-22,SURREY AND SUSSEX HEALTHCARE NHS TRUST,Suspected urological malignancies (excluding testicular),177,115,62
Sep-22,ROYAL SURREY COUNTY HOSPITAL NHS FOUNDATION TRUST,Suspected breast cancer,176,169,7
Sep-22,SURREY AND SUSSEX HEALTHCARE NHS TRUST,Suspected breast cancer,285,178,107
Sep-22,FRIMLEY HEALTH NHS FOUNDATION TRUST,Suspected breast cancer,500,384,116
Sep-22,ASHFORD AND ST PETER'S HOSPITALS NHS FOUNDATION TRUST,Suspected breast cancer,224,168,56
Sep-22,EAST SUSSEX HEALTHCARE NHS TRUST,Suspected breast cancer,312,222,90
Sep-22,ROYAL SURREY COUNTY HOSPITAL NHS FOUNDATION TRUST,Suspected gynaecological cancer,66,46,20
Sep-22,UNIVERSITY HOSPITALS SUSSEX NHS FOUNDATION TRUST,Suspected breast cancer,608,465,143
Sep-22,FRIMLEY HEALTH NHS FOUNDATION TRUST,Suspected gynaecological cancer,216,127,89
Sep-22,SURREY AND SUSSEX HEALTHCARE NHS TRUST,Suspected gynaecological cancer,218,98,120
Sep-22,UNIVERSITY HOSPITALS SUSSEX NHS FOUNDATION TRUST,Suspected gynaecological cancer,388,173,215
Sep-22,EAST SUSSEX HEALTHCARE NHS TRUST,Suspected gynaecological cancer,217,142,75
Sep-22,ROYAL SURREY COUNTY HOSPITAL NHS FOUNDATION TRUST,Suspected head & neck cancer,133,125,8
Sep-22,QUEEN VICTORIA HOSPITAL NHS FOUNDATION TRUST,Suspected head & neck cancer,202,175,27
Sep-22,ASHFORD AND ST PETER'S HOSPITALS NHS FOUNDATION TRUST,Suspected gynaecological cancer,115,72,43
Sep-22,SURREY AND SUSSEX HEALTHCARE NHS TRUST,Suspected head & neck cancer,94,64,30
Sep-22,EAST SUSSEX HEALTHCARE NHS TRUST,Suspected head & neck cancer,199,147,52
Sep-22,UNIVERSITY HOSPITALS SUSSEX NHS FOUNDATION TRUST,Suspected head & neck cancer,436,286,150
Sep-22,FRIMLEY HEALTH NHS FOUNDATION TRUST,Suspected head & neck cancer,244,203,41
Sep-22,FRIMLEY HEALTH NHS FOUNDATION TRUST,Suspected lower gastrointestinal cancer,521,239,282
Sep-22,ROYAL SURREY COUNTY HOSPITAL NHS FOUNDATION TRUST,Suspected lower gastrointestinal cancer,232,178,54
Sep-22,ASHFORD AND ST PETER'S HOSPITALS NHS FOUNDATION TRUST,Suspected head & neck cancer,179,129,50
Sep-22,ASHFORD AND ST PETER'S HOSPITALS NHS FOUNDATION TRUST,Suspected lower gastrointestinal cancer,431,284,147
Sep-22,EAST SUSSEX HEALTHCARE NHS TRUST,Suspected lower gastrointestinal cancer,577,324,253
Sep-22,UNIVERSITY HOSPITALS SUSSEX NHS FOUNDATION TRUST,Suspected lower gastrointestinal cancer,1106,375,731
Sep-22,FRIMLEY HEALTH NHS FOUNDATION TRUST,Suspected lung cancer,75,61,14
Sep-22,ROYAL SURREY COUNTY HOSPITAL NHS FOUNDATION TRUST,Suspected lung cancer,19,11,8
Sep-22,SURREY AND SUSSEX HEALTHCARE NHS TRUST,Suspected lower gastrointestinal cancer,380,89,291
Sep-22,ASHFORD AND ST PETER'S HOSPITALS NHS FOUNDATION TRUST,Suspected lung cancer,22,10,12
Sep-22,EAST SUSSEX HEALTHCARE NHS TRUST,Suspected lung cancer,40,16,24
Sep-22,SURREY AND SUSSEX HEALTHCARE NHS TRUST,Suspected lung cancer,56,46,10
Sep-22,UNIVERSITY HOSPITALS SUSSEX NHS FOUNDATION TRUST,Suspected lung cancer,53,41,12
Sep-22,QUEEN VICTORIA HOSPITAL NHS FOUNDATION TRUST,Suspected skin cancer,203,167,36
Sep-22,EAST SUSSEX HEALTHCARE NHS TRUST,Suspected skin cancer,575,481,94
Sep-22,ASHFORD AND ST PETER'S HOSPITALS NHS FOUNDATION TRUST,Suspected skin cancer,443,354,89
Sep-22,SURREY AND SUSSEX HEALTHCARE NHS TRUST,Suspected skin cancer,531,502,29
Sep-22,UNIVERSITY HOSPITALS SUSSEX NHS FOUNDATION TRUST,Suspected skin cancer,1146,1019,127
Sep-22,FRIMLEY HEALTH NHS FOUNDATION TRUST,Suspected skin cancer,561,463,98
Sep-22,ROYAL SURREY COUNTY HOSPITAL NHS FOUNDATION TRUST,Suspected skin cancer,17,15,2
Sep-22,FRIMLEY HEALTH NHS FOUNDATION TRUST,Suspected upper gastrointestinal cancer,154,115,39
Sep-22,SURREY AND SUSSEX HEALTHCARE NHS TRUST,Suspected upper gastrointestinal cancer,134,88,46
Sep-22,ASHFORD AND ST PETER'S HOSPITALS NHS FOUNDATION TRUST,Suspected upper gastrointestinal cancer,162,73,89
Sep-22,FRIMLEY HEALTH NHS FOUNDATION TRUST,Suspected urological malignancies (excluding testicular),184,109,75
Sep-22,ROYAL SURREY COUNTY HOSPITAL NHS FOUNDATION TRUST,Suspected urological malignancies (excluding testicular),90,78,12
Sep-22,EAST SUSSEX HEALTHCARE NHS TRUST,Suspected upper gastrointestinal cancer,129,101,28
Sep-22,ROYAL SURREY COUNTY HOSPITAL NHS FOUNDATION TRUST,Suspected upper gastrointestinal cancer,63,50,13
Sep-22,EAST SUSSEX HEALTHCARE NHS TRUST,Suspected urological malignancies (excluding testicular),197,117,80
Sep-22,UNIVERSITY HOSPITALS SUSSEX NHS FOUNDATION TRUST,Suspected urological malignancies (excluding testicular),470,228,242
Sep-22,UNIVERSITY HOSPITALS SUSSEX NHS FOUNDATION TRUST,Suspected upper gastrointestinal cancer,325,186,139
Sep-22,SURREY AND SUSSEX HEALTHCARE NHS TRUST,Suspected urological malignancies (excluding testicular),163,85,78
Sep-22,ASHFORD AND ST PETER'S HOSPITALS NHS FOUNDATION TRUST,Suspected urological malignancies (excluding testicular),118,88,30
Oct-22,FRIMLEY HEALTH NHS FOUNDATION TRUST,Suspected breast cancer,511,390,121
Oct-22,ROYAL SURREY COUNTY HOSPITAL NHS FOUNDATION TRUST,Suspected breast cancer,181,176,5
Oct-22,EAST SUSSEX HEALTHCARE NHS TRUST,Suspected breast cancer,261,228,33
Oct-22,ASHFORD AND ST PETER'S HOSPITALS NHS FOUNDATION TRUST,Suspected breast cancer,221,185,36
Oct-22,UNIVERSITY HOSPITALS SUSSEX NHS FOUNDATION TRUST,Suspected breast cancer,652,436,216
Oct-22,ROYAL SURREY COUNTY HOSPITAL NHS FOUNDATION TRUST,Suspected gynaecological cancer,48,39,9
Oct-22,SURREY AND SUSSEX HEALTHCARE NHS TRUST,Suspected breast cancer,297,179,118
Oct-22,SURREY AND SUSSEX HEALTHCARE NHS TRUST,Suspected gynaecological cancer,192,112,80
Oct-22,EAST SUSSEX HEALTHCARE NHS TRUST,Suspected gynaecological cancer,218,156,62
Oct-22,FRIMLEY HEALTH NHS FOUNDATION TRUST,Suspected gynaecological cancer,182,114,68
Oct-22,ASHFORD AND ST PETER'S HOSPITALS NHS FOUNDATION TRUST,Suspected gynaecological cancer,189,99,90
Oct-22,UNIVERSITY HOSPITALS SUSSEX NHS FOUNDATION TRUST,Suspected gynaecological cancer,412,162,250
Oct-22,FRIMLEY HEALTH NHS FOUNDATION TRUST,Suspected head & neck cancer,270,210,60
Oct-22,EAST SUSSEX HEALTHCARE NHS TRUST,Suspected head & neck cancer,164,134,30
Oct-22,QUEEN VICTORIA HOSPITAL NHS FOUNDATION TRUST,Suspected head & neck cancer,225,188,37
Oct-22,ROYAL SURREY COUNTY HOSPITAL NHS FOUNDATION TRUST,Suspected lower gastrointestinal cancer,259,202,57
Oct-22,FRIMLEY HEALTH NHS FOUNDATION TRUST,Suspected lower gastrointestinal cancer,781,261,520
Oct-22,ROYAL SURREY COUNTY HOSPITAL NHS FOUNDATION TRUST,Suspected head & neck cancer,165,154,11
Oct-22,ASHFORD AND ST PETER'S HOSPITALS NHS FOUNDATION TRUST,Suspected head & neck cancer,131,98,33
Oct-22,SURREY AND SUSSEX HEALTHCARE NHS TRUST,Suspected lower gastrointestinal cancer,523,105,418
Oct-22,ASHFORD AND ST PETER'S HOSPITALS NHS FOUNDATION TRUST,Suspected lower gastrointestinal cancer,440,305,135
Oct-22,EAST SUSSEX HEALTHCARE NHS TRUST,Suspected lower gastrointestinal cancer,363,207,156
Oct-22,SURREY AND SUSSEX HEALTHCARE NHS TRUST,Suspected head & neck cancer,103,73,30
Oct-22,UNIVERSITY HOSPITALS SUSSEX NHS FOUNDATION TRUST,Suspected head & neck cancer,404,287,117
Oct-22,UNIVERSITY HOSPITALS SUSSEX NHS FOUNDATION TRUST,Suspected lower gastrointestinal cancer,1262,528,734
Oct-22,ASHFORD AND ST PETER'S HOSPITALS NHS FOUNDATION TRUST,Suspected lung cancer,37,30,7
Oct-22,ROYAL SURREY COUNTY HOSPITAL NHS FOUNDATION TRUST,Suspected lung cancer,17,6,11
Oct-22,FRIMLEY HEALTH NHS FOUNDATION TRUST,Suspected lung cancer,57,44,13
Oct-22,SURREY AND SUSSEX HEALTHCARE NHS TRUST,Suspected lung cancer,49,40,9
Oct-22,ROYAL SURREY COUNTY HOSPITAL NHS FOUNDATION TRUST,Suspected skin cancer,6,4,2
Oct-22,UNIVERSITY HOSPITALS SUSSEX NHS FOUNDATION TRUST,Suspected lung cancer,53,45,8
Oct-22,EAST SUSSEX HEALTHCARE NHS TRUST,Suspected lung cancer,32,23,9
Oct-22,FRIMLEY HEALTH NHS FOUNDATION TRUST,Suspected skin cancer,569,500,69
Oct-22,QUEEN VICTORIA HOSPITAL NHS FOUNDATION TRUST,Suspected skin cancer,226,179,47
Oct-22,SURREY AND SUSSEX HEALTHCARE NHS TRUST,Suspected skin cancer,451,435,16
Oct-22,ASHFORD AND ST PETER'S HOSPITALS NHS FOUNDATION TRUST,Suspected skin cancer,378,182,196
Oct-22,UNIVERSITY HOSPITALS SUSSEX NHS FOUNDATION TRUST,Suspected skin cancer,964,842,122
Oct-22,EAST SUSSEX HEALTHCARE NHS TRUST,Suspected skin cancer,544,435,109
Oct-22,ROYAL SURREY COUNTY HOSPITAL NHS FOUNDATION TRUST,Suspected upper gastrointestinal cancer,67,49,18
Oct-22,SURREY AND SUSSEX HEALTHCARE NHS TRUST,Suspected upper gastrointestinal cancer,171,111,60
Oct-22,FRIMLEY HEALTH NHS FOUNDATION TRUST,Suspected upper gastrointestinal cancer,197,134,63
Oct-22,ASHFORD AND ST PETER'S HOSPITALS NHS FOUNDATION TRUST,Suspected urological malignancies (excluding testicular),137,113,24
Oct-22,EAST SUSSEX HEALTHCARE NHS TRUST,Suspected urological malignancies (excluding testicular),195,139,56
Oct-22,ROYAL SURREY COUNTY HOSPITAL NHS FOUNDATION TRUST,Suspected urological malignancies (excluding testicular),116,110,6
Oct-22,ASHFORD AND ST PETER'S HOSPITALS NHS FOUNDATION TRUST,Suspected upper gastrointestinal cancer,113,70,43
Oct-22,SURREY AND SUSSEX HEALTHCARE NHS TRUST,Suspected urological malignancies (excluding testicular),174,100,74
Oct-22,EAST SUSSEX HEALTHCARE NHS TRUST,Suspected upper gastrointestinal cancer,129,95,34
Oct-22,FRIMLEY HEALTH NHS FOUNDATION TRUST,Suspected urological malignancies (excluding testicular),223,130,93
Oct-22,UNIVERSITY HOSPITALS SUSSEX NHS FOUNDATION TRUST,Suspected upper gastrointestinal cancer,404,262,142
Oct-22,UNIVERSITY HOSPITALS SUSSEX NHS FOUNDATION TRUST,Suspected urological malignancies (excluding testicular),514,265,249
Nov-22,ROYAL SURREY COUNTY HOSPITAL NHS FOUNDATION TRUST,Suspected breast cancer,230,219,11
Nov-22,SURREY AND SUSSEX HEALTHCARE NHS TRUST,Suspected breast cancer,313,170,143
Nov-22,EAST SUSSEX HEALTHCARE NHS TRUST,Suspected breast cancer,242,213,29
Nov-22,FRIMLEY HEALTH NHS FOUNDATION TRUST,Suspected breast cancer,631,517,114
Nov-22,UNIVERSITY HOSPITALS SUSSEX NHS FOUNDATION TRUST,Suspected breast cancer,626,447,179
Nov-22,ASHFORD AND ST PETER'S HOSPITALS NHS FOUNDATION TRUST,Suspected breast cancer,243,190,53
Nov-22,FRIMLEY HEALTH NHS FOUNDATION TRUST,Suspected gynaecological cancer,205,138,67
Nov-22,ASHFORD AND ST PETER'S HOSPITALS NHS FOUNDATION TRUST,Suspected gynaecological cancer,168,106,62
Nov-22,ROYAL SURREY COUNTY HOSPITAL NHS FOUNDATION TRUST,Suspected gynaecological cancer,43,39,4
Nov-22,UNIVERSITY HOSPITALS SUSSEX NHS FOUNDATION TRUST,Suspected gynaecological cancer,528,257,271
Nov-22,SURREY AND SUSSEX HEALTHCARE NHS TRUST,Suspected gynaecological cancer,214,99,115
Nov-22,ROYAL SURREY COUNTY HOSPITAL NHS FOUNDATION TRUST,Suspected head & neck cancer,178,174,4
Nov-22,EAST SUSSEX HEALTHCARE NHS TRUST,Suspected gynaecological cancer,175,146,29
Nov-22,FRIMLEY HEALTH NHS FOUNDATION TRUST,Suspected head & neck cancer,243,189,54
Nov-22,EAST SUSSEX HEALTHCARE NHS TRUST,Suspected head & neck cancer,209,160,49
Nov-22,ASHFORD AND ST PETER'S HOSPITALS NHS FOUNDATION TRUST,Suspected head & neck cancer,153,111,42
Nov-22,UNIVERSITY HOSPITALS SUSSEX NHS FOUNDATION TRUST,Suspected head & neck cancer,413,294,119
Nov-22,QUEEN VICTORIA HOSPITAL NHS FOUNDATION TRUST,Suspected head & neck cancer,267,237,30
Nov-22,SURREY AND SUSSEX HEALTHCARE NHS TRUST,Suspected head & neck cancer,142,85,57
Nov-22,ROYAL SURREY COUNTY HOSPITAL NHS FOUNDATION TRUST,Suspected lower gastrointestinal cancer,279,218,61
Nov-22,ASHFORD AND ST PETER'S HOSPITALS NHS FOUNDATION TRUST,Suspected lower gastrointestinal cancer,389,281,108
Nov-22,SURREY AND SUSSEX HEALTHCARE NHS TRUST,Suspected lower gastrointestinal cancer,545,150,395
Nov-22,UNIVERSITY HOSPITALS SUSSEX NHS FOUNDATION TRUST,Suspected lower gastrointestinal cancer,1126,559,567
Nov-22,ROYAL SURREY COUNTY HOSPITAL NHS FOUNDATION TRUST,Suspected lung cancer,31,18,13
Nov-22,EAST SUSSEX HEALTHCARE NHS TRUST,Suspected lower gastrointestinal cancer,534,369,165
Nov-22,FRIMLEY HEALTH NHS FOUNDATION TRUST,Suspected lower gastrointestinal cancer,708,331,377
Nov-22,FRIMLEY HEALTH NHS FOUNDATION TRUST,Suspected lung cancer,109,76,33
Nov-22,ASHFORD AND ST PETER'S HOSPITALS NHS FOUNDATION TRUST,Suspected lung cancer,48,34,14
Nov-22,UNIVERSITY HOSPITALS SUSSEX NHS FOUNDATION TRUST,Suspected lung cancer,69,62,7
Nov-22,EAST SUSSEX HEALTHCARE NHS TRUST,Suspected lung cancer,46,8,38
Nov-22,SURREY AND SUSSEX HEALTHCARE NHS TRUST,Suspected lung cancer,57,44,13
Nov-22,FRIMLEY HEALTH NHS FOUNDATION TRUST,Suspected skin cancer,565,433,132
Nov-22,SURREY AND SUSSEX HEALTHCARE NHS TRUST,Suspected skin cancer,480,463,17
Nov-22,UNIVERSITY HOSPITALS SUSSEX NHS FOUNDATION TRUST,Suspected skin cancer,789,734,55
Nov-22,QUEEN VICTORIA HOSPITAL NHS FOUNDATION TRUST,Suspected skin cancer,212,167,45
Nov-22,EAST SUSSEX HEALTHCARE NHS TRUST,Suspected skin cancer,688,571,117
Nov-22,ROYAL SURREY COUNTY HOSPITAL NHS FOUNDATION TRUST,Suspected skin cancer,23,23,0
Nov-22,ASHFORD AND ST PETER'S HOSPITALS NHS FOUNDATION TRUST,Suspected skin cancer,434,317,117
Nov-22,FRIMLEY HEALTH NHS FOUNDATION TRUST,Suspected upper gastrointestinal cancer,210,150,60
Nov-22,EAST SUSSEX HEALTHCARE NHS TRUST,Suspected upper gastrointestinal cancer,155,115,40
Nov-22,ASHFORD AND ST PETER'S HOSPITALS NHS FOUNDATION TRUST,Suspected upper gastrointestinal cancer,115,64,51
Nov-22,ROYAL SURREY COUNTY HOSPITAL NHS FOUNDATION TRUST,Suspected upper gastrointestinal cancer,45,35,10
Nov-22,ROYAL SURREY COUNTY HOSPITAL NHS FOUNDATION TRUST,Suspected urological malignancies (excluding testicular),101,96,5
Nov-22,SURREY AND SUSSEX HEALTHCARE NHS TRUST,Suspected upper gastrointestinal cancer,151,106,45
Nov-22,FRIMLEY HEALTH NHS FOUNDATION TRUST,Suspected urological malignancies (excluding testicular),298,180,118
Nov-22,UNIVERSITY HOSPITALS SUSSEX NHS FOUNDATION TRUST,Suspected urological malignancies (excluding testicular),469,215,254
Nov-22,ASHFORD AND ST PETER'S HOSPITALS NHS FOUNDATION TRUST,Suspected urological malignancies (excluding testicular),145,96,49
Nov-22,SURREY AND SUSSEX HEALTHCARE NHS TRUST,Suspected urological malignancies (excluding testicular),185,91,94
Nov-22,UNIVERSITY HOSPITALS SUSSEX NHS FOUNDATION TRUST,Suspected upper gastrointestinal cancer,332,211,121
Nov-22,EAST SUSSEX HEALTHCARE NHS TRUST,Suspected urological malignancies (excluding testicular),192,121,71
Dec-22,ROYAL SURREY COUNTY HOSPITAL NHS FOUNDATION TRUST,Suspected breast cancer,245,233,12
Dec-22,FRIMLEY HEALTH NHS FOUNDATION TRUST,Suspected breast cancer,414,300,114
Dec-22,SURREY AND SUSSEX HEALTHCARE NHS TRUST,Suspected breast cancer,259,118,141
Dec-22,ASHFORD AND ST PETER'S HOSPITALS NHS FOUNDATION TRUST,Suspected breast cancer,265,201,64
Dec-22,UNIVERSITY HOSPITALS SUSSEX NHS FOUNDATION TRUST,Suspected breast cancer,542,342,200
Dec-22,EAST SUSSEX HEALTHCARE NHS TRUST,Suspected breast cancer,186,161,25
Dec-22,ROYAL SURREY COUNTY HOSPITAL NHS FOUNDATION TRUST,Suspected gynaecological cancer,21,19,2
Dec-22,UNIVERSITY HOSPITALS SUSSEX NHS FOUNDATION TRUST,Suspected gynaecological cancer,381,178,203
Dec-22,FRIMLEY HEALTH NHS FOUNDATION TRUST,Suspected gynaecological cancer,156,125,31
Dec-22,SURREY AND SUSSEX HEALTHCARE NHS TRUST,Suspected gynaecological cancer,186,86,100
Dec-22,ASHFORD AND ST PETER'S HOSPITALS NHS FOUNDATION TRUST,Suspected gynaecological cancer,91,53,38
Dec-22,UNIVERSITY HOSPITALS SUSSEX NHS FOUNDATION TRUST,Suspected head & neck cancer,337,230,107
Dec-22,QUEEN VICTORIA HOSPITAL NHS FOUNDATION TRUST,Suspected head & neck cancer,233,213,20
Dec-22,EAST SUSSEX HEALTHCARE NHS TRUST,Suspected gynaecological cancer,178,107,71
Dec-22,ROYAL SURREY COUNTY HOSPITAL NHS FOUNDATION TRUST,Suspected lower gastrointestinal cancer,265,230,35
Dec-22,FRIMLEY HEALTH NHS FOUNDATION TRUST,Suspected head & neck cancer,237,175,62
Dec-22,ROYAL SURREY COUNTY HOSPITAL NHS FOUNDATION TRUST,Suspected head & neck cancer,140,134,6
Dec-22,ASHFORD AND ST PETER'S HOSPITALS NHS FOUNDATION TRUST,Suspected head & neck cancer,156,110,46
Dec-22,SURREY AND SUSSEX HEALTHCARE NHS TRUST,Suspected head & neck cancer,86,60,26
Dec-22,FRIMLEY HEALTH NHS FOUNDATION TRUST,Suspected lung cancer,91,68,23
Dec-22,SURREY AND SUSSEX HEALTHCARE NHS TRUST,Suspected lower gastrointestinal cancer,438,137,301
Dec-22,EAST SUSSEX HEALTHCARE NHS TRUST,Suspected lower gastrointestinal cancer,427,304,123
Dec-22,FRIMLEY HEALTH NHS FOUNDATION TRUST,Suspected lower gastrointestinal cancer,477,173,304
Dec-22,EAST SUSSEX HEALTHCARE NHS TRUST,Suspected head & neck cancer,178,140,38
Dec-22,ROYAL SURREY COUNTY HOSPITAL NHS FOUNDATION TRUST,Suspected lung cancer,18,15,3
Dec-22,ASHFORD AND ST PETER'S HOSPITALS NHS FOUNDATION TRUST,Suspected lower gastrointestinal cancer,292,221,71
Dec-22,UNIVERSITY HOSPITALS SUSSEX NHS FOUNDATION TRUST,Suspected lung cancer,64,51,13
Dec-22,UNIVERSITY HOSPITALS SUSSEX NHS FOUNDATION TRUST,Suspected lower gastrointestinal cancer,924,518,406
Dec-22,SURREY AND SUSSEX HEALTHCARE NHS TRUST,Suspected lung cancer,46,34,12
Dec-22,ASHFORD AND ST PETER'S HOSPITALS NHS FOUNDATION TRUST,Suspected lung cancer,26,19,7
Dec-22,EAST SUSSEX HEALTHCARE NHS TRUST,Suspected lung cancer,31,9,22
Dec-22,ROYAL SURREY COUNTY HOSPITAL NHS FOUNDATION TRUST,Suspected skin cancer,10,10,0
Dec-22,FRIMLEY HEALTH NHS FOUNDATION TRUST,Suspected skin cancer,424,268,156
Dec-22,EAST SUSSEX HEALTHCARE NHS TRUST,Suspected skin cancer,321,276,45
Dec-22,UNIVERSITY HOSPITALS SUSSEX NHS FOUNDATION TRUST,Suspected skin cancer,641,582,59
Dec-22,QUEEN VICTORIA HOSPITAL NHS FOUNDATION TRUST,Suspected skin cancer,184,134,50
Dec-22,SURREY AND SUSSEX HEALTHCARE NHS TRUST,Suspected skin cancer,259,248,11
Dec-22,ROYAL SURREY COUNTY HOSPITAL NHS FOUNDATION TRUST,Suspected upper gastrointestinal cancer,19,12,7
Dec-22,ASHFORD AND ST PETER'S HOSPITALS NHS FOUNDATION TRUST,Suspected skin cancer,357,305,52
Dec-22,ASHFORD AND ST PETER'S HOSPITALS NHS FOUNDATION TRUST,Suspected upper gastrointestinal cancer,101,60,41
Dec-22,FRIMLEY HEALTH NHS FOUNDATION TRUST,Suspected upper gastrointestinal cancer,207,109,98
Dec-22,ROYAL SURREY COUNTY HOSPITAL NHS FOUNDATION TRUST,Suspected urological malignancies (excluding testicular),94,87,7
Dec-22,SURREY AND SUSSEX HEALTHCARE NHS TRUST,Suspected upper gastrointestinal cancer,123,92,31
Dec-22,FRIMLEY HEALTH NHS FOUNDATION TRUST,Suspected urological malignancies (excluding testicular),250,142,108
Dec-22,ASHFORD AND ST PETER'S HOSPITALS NHS FOUNDATION TRUST,Suspected urological malignancies (excluding testicular),114,86,28
Dec-22,UNIVERSITY HOSPITALS SUSSEX NHS FOUNDATION TRUST,Suspected upper gastrointestinal cancer,248,169,79
Dec-22,EAST SUSSEX HEALTHCARE NHS TRUST,Suspected upper gastrointestinal cancer,115,91,24
Dec-22,EAST SUSSEX HEALTHCARE NHS TRUST,Suspected urological malignancies (excluding testicular),171,98,73
Dec-22,UNIVERSITY HOSPITALS SUSSEX NHS FOUNDATION TRUST,Suspected urological malignancies (excluding testicular),468,280,188
Dec-22,SURREY AND SUSSEX HEALTHCARE NHS TRUST,Suspected urological malignancies (excluding testicular),155,92,63
Jan-23,ROYAL SURREY COUNTY HOSPITAL NHS FOUNDATION TRUST,Suspected breast cancer,208,205,3
Jan-23,FRIMLEY HEALTH NHS FOUNDATION TRUST,Suspected breast cancer,557,439,118
Jan-23,SURREY AND SUSSEX HEALTHCARE NHS TRUST,Suspected breast cancer,333,178,155
Jan-23,ASHFORD AND ST PETER'S HOSPITALS NHS FOUNDATION TRUST,Suspected breast cancer,226,194,32
Jan-23,UNIVERSITY HOSPITALS SUSSEX NHS FOUNDATION TRUST,Suspected breast cancer,627,355,272
Jan-23,EAST SUSSEX HEALTHCARE NHS TRUST,Suspected breast cancer,220,179,41
Jan-23,SURREY AND SUSSEX HEALTHCARE NHS TRUST,Suspected gynaecological cancer,223,89,134
Jan-23,EAST SUSSEX HEALTHCARE NHS TRUST,Suspected gynaecological cancer,162,127,35
Jan-23,ROYAL SURREY COUNTY HOSPITAL NHS FOUNDATION TRUST,Suspected gynaecological cancer,29,23,6
Jan-23,FRIMLEY HEALTH NHS FOUNDATION TRUST,Suspected gynaecological cancer,153,94,59
Jan-23,ROYAL SURREY COUNTY HOSPITAL NHS FOUNDATION TRUST,Suspected head & neck cancer,138,126,12
Jan-23,UNIVERSITY HOSPITALS SUSSEX NHS FOUNDATION TRUST,Suspected gynaecological cancer,508,262,246
Jan-23,ASHFORD AND ST PETER'S HOSPITALS NHS FOUNDATION TRUST,Suspected gynaecological cancer,142,65,77
Jan-23,SURREY AND SUSSEX HEALTHCARE NHS TRUST,Suspected head & neck cancer,129,85,44
Jan-23,QUEEN VICTORIA HOSPITAL NHS FOUNDATION TRUST,Suspected head & neck cancer,228,195,33
Jan-23,ROYAL SURREY COUNTY HOSPITAL NHS FOUNDATION TRUST,Suspected lower gastrointestinal cancer,203,172,31
Jan-23,ASHFORD AND ST PETER'S HOSPITALS NHS FOUNDATION TRUST,Suspected head & neck cancer,112,86,26
Jan-23,SURREY AND SUSSEX HEALTHCARE NHS TRUST,Suspected lower gastrointestinal cancer,499,151,348
Jan-23,UNIVERSITY HOSPITALS SUSSEX NHS FOUNDATION TRUST,Suspected head & neck cancer,407,243,164
Jan-23,EAST SUSSEX HEALTHCARE NHS TRUST,Suspected lower gastrointestinal cancer,439,278,161
Jan-23,FRIMLEY HEALTH NHS FOUNDATION TRUST,Suspected lower gastrointestinal cancer,628,174,454
Jan-23,ASHFORD AND ST PETER'S HOSPITALS NHS FOUNDATION TRUST,Suspected lower gastrointestinal cancer,357,225,132
Jan-23,FRIMLEY HEALTH NHS FOUNDATION TRUST,Suspected head & neck cancer,224,164,60
Jan-23,ROYAL SURREY COUNTY HOSPITAL NHS FOUNDATION TRUST,Suspected lung cancer,22,16,6
Jan-23,ASHFORD AND ST PETER'S HOSPITALS NHS FOUNDATION TRUST,Suspected lung cancer,27,23,4
Jan-23,SURREY AND SUSSEX HEALTHCARE NHS TRUST,Suspected lung cancer,59,53,6
Jan-23,EAST SUSSEX HEALTHCARE NHS TRUST,Suspected head & neck cancer,179,143,36
Jan-23,EAST SUSSEX HEALTHCARE NHS TRUST,Suspected lung cancer,61,19,42
Jan-23,ROYAL SURREY COUNTY HOSPITAL NHS FOUNDATION TRUST,Suspected skin cancer,8,7,1
Jan-23,UNIVERSITY HOSPITALS SUSSEX NHS FOUNDATION TRUST,Suspected lower gastrointestinal cancer,1006,419,587
Jan-23,EAST SUSSEX HEALTHCARE NHS TRUST,Suspected skin cancer,377,324,53
Jan-23,FRIMLEY HEALTH NHS FOUNDATION TRUST,Suspected skin cancer,568,328,240
Jan-23,UNIVERSITY HOSPITALS SUSSEX NHS FOUNDATION TRUST,Suspected skin cancer,1098,904,194
Jan-23,ASHFORD AND ST PETER'S HOSPITALS NHS FOUNDATION TRUST,Suspected skin cancer,365,342,23
Jan-23,FRIMLEY HEALTH NHS FOUNDATION TRUST,Suspected lung cancer,95,60,35
Jan-23,UNIVERSITY HOSPITALS SUSSEX NHS FOUNDATION TRUST,Suspected lung cancer,80,63,17
Jan-23,QUEEN VICTORIA HOSPITAL NHS FOUNDATION TRUST,Suspected skin cancer,203,160,43
Jan-23,ROYAL SURREY COUNTY HOSPITAL NHS FOUNDATION TRUST,Suspected upper gastrointestinal cancer,44,35,9
Jan-23,SURREY AND SUSSEX HEALTHCARE NHS TRUST,Suspected upper gastrointestinal cancer,141,90,51
Jan-23,FRIMLEY HEALTH NHS FOUNDATION TRUST,Suspected upper gastrointestinal cancer,231,137,94
Jan-23,UNIVERSITY HOSPITALS SUSSEX NHS FOUNDATION TRUST,Suspected upper gastrointestinal cancer,339,215,124
Jan-23,ROYAL SURREY COUNTY HOSPITAL NHS FOUNDATION TRUST,Suspected urological malignancies (excluding testicular),95,89,6
Jan-23,ASHFORD AND ST PETER'S HOSPITALS NHS FOUNDATION TRUST,Suspected upper gastrointestinal cancer,106,60,46
Jan-23,EAST SUSSEX HEALTHCARE NHS TRUST,Suspected upper gastrointestinal cancer,108,85,23
Jan-23,ASHFORD AND ST PETER'S HOSPITALS NHS FOUNDATION TRUST,Suspected urological malignancies (excluding testicular),125,95,30
Jan-23,FRIMLEY HEALTH NHS FOUNDATION TRUST,Suspected urological malignancies (excluding testicular),258,133,125
Jan-23,SURREY AND SUSSEX HEALTHCARE NHS TRUST,Suspected skin cancer,490,437,53
Jan-23,EAST SUSSEX HEALTHCARE NHS TRUST,Suspected urological malignancies (excluding testicular),180,94,86
Jan-23,SURREY AND SUSSEX HEALTHCARE NHS TRUST,Suspected urological malignancies (excluding testicular),194,89,105
Jan-23,UNIVERSITY HOSPITALS SUSSEX NHS FOUNDATION TRUST,Suspected urological malignancies (excluding testicular),427,209,218
Feb-23,FRIMLEY HEALTH NHS FOUNDATION TRUST,Suspected breast cancer,592,467,125
Feb-23,ROYAL SURREY COUNTY HOSPITAL NHS FOUNDATION TRUST,Suspected breast cancer,187,185,2
Feb-23,ASHFORD AND ST PETER'S HOSPITALS NHS FOUNDATION TRUST,Suspected breast cancer,186,171,15
Feb-23,SURREY AND SUSSEX HEALTHCARE NHS TRUST,Suspected breast cancer,348,232,116
Feb-23,EAST SUSSEX HEALTHCARE NHS TRUST,Suspected breast cancer,225,190,35
Feb-23,UNIVERSITY HOSPITALS SUSSEX NHS FOUNDATION TRUST,Suspected breast cancer,762,670,92
Feb-23,ROYAL SURREY COUNTY HOSPITAL NHS FOUNDATION TRUST,Suspected gynaecological cancer,50,41,9
Feb-23,ASHFORD AND ST PETER'S HOSPITALS NHS FOUNDATION TRUST,Suspected gynaecological cancer,142,105,37
Feb-23,FRIMLEY HEALTH NHS FOUNDATION TRUST,Suspected gynaecological cancer,192,116,76
Feb-23,UNIVERSITY HOSPITALS SUSSEX NHS FOUNDATION TRUST,Suspected gynaecological cancer,514,328,186
Feb-23,SURREY AND SUSSEX HEALTHCARE NHS TRUST,Suspected gynaecological cancer,182,82,100
Feb-23,EAST SUSSEX HEALTHCARE NHS TRUST,Suspected gynaecological cancer,177,130,47
Feb-23,SURREY AND SUSSEX HEALTHCARE NHS TRUST,Suspected head & neck cancer,95,72,23
Feb-23,ROYAL SURREY COUNTY HOSPITAL NHS FOUNDATION TRUST,Suspected head & neck cancer,155,147,8
Feb-23,FRIMLEY HEALTH NHS FOUNDATION TRUST,Suspected head & neck cancer,205,163,42
Feb-23,ASHFORD AND ST PETER'S HOSPITALS NHS FOUNDATION TRUST,Suspected lower gastrointestinal cancer,400,316,84
Feb-23,QUEEN VICTORIA HOSPITAL NHS FOUNDATION TRUST,Suspected head & neck cancer,240,207,33
Feb-23,ASHFORD AND ST PETER'S HOSPITALS NHS FOUNDATION TRUST,Suspected head & neck cancer,127,115,12
Feb-23,FRIMLEY HEALTH NHS FOUNDATION TRUST,Suspected lower gastrointestinal cancer,545,222,323
Feb-23,ROYAL SURREY COUNTY HOSPITAL NHS FOUNDATION TRUST,Suspected lower gastrointestinal cancer,197,174,23
Feb-23,SURREY AND SUSSEX HEALTHCARE NHS TRUST,Suspected lower gastrointestinal cancer,490,209,281
Feb-23,UNIVERSITY HOSPITALS SUSSEX NHS FOUNDATION TRUST,Suspected head & neck cancer,482,305,177
Feb-23,EAST SUSSEX HEALTHCARE NHS TRUST,Suspected head & neck cancer,166,138,28
Feb-23,FRIMLEY HEALTH NHS FOUNDATION TRUST,Suspected lung cancer,99,84,15
Feb-23,ASHFORD AND ST PETER'S HOSPITALS NHS FOUNDATION TRUST,Suspected lung cancer,31,22,9
Feb-23,SURREY AND SUSSEX HEALTHCARE NHS TRUST,Suspected lung cancer,56,47,9
Feb-23,UNIVERSITY HOSPITALS SUSSEX NHS FOUNDATION TRUST,Suspected lung cancer,75,69,6
Feb-23,EAST SUSSEX HEALTHCARE NHS TRUST,Suspected lower gastrointestinal cancer,383,298,85
Feb-23,UNIVERSITY HOSPITALS SUSSEX NHS FOUNDATION TRUST,Suspected lower gastrointestinal cancer,968,570,398
Feb-23,ROYAL SURREY COUNTY HOSPITAL NHS FOUNDATION TRUST,Suspected lung cancer,17,17,0
Feb-23,EAST SUSSEX HEALTHCARE NHS TRUST,Suspected lung cancer,57,34,23
Feb-23,UNIVERSITY HOSPITALS SUSSEX NHS FOUNDATION TRUST,Suspected skin cancer,860,798,62
Feb-23,QUEEN VICTORIA HOSPITAL NHS FOUNDATION TRUST,Suspected skin cancer,201,179,22
Feb-23,ASHFORD AND ST PETER'S HOSPITALS NHS FOUNDATION TRUST,Suspected skin cancer,390,371,19
Feb-23,EAST SUSSEX HEALTHCARE NHS TRUST,Suspected skin cancer,491,449,42
Feb-23,ROYAL SURREY COUNTY HOSPITAL NHS FOUNDATION TRUST,Suspected skin cancer,5,5,0
Feb-23,FRIMLEY HEALTH NHS FOUNDATION TRUST,Suspected skin cancer,424,294,130
Feb-23,ASHFORD AND ST PETER'S HOSPITALS NHS FOUNDATION TRUST,Suspected upper gastrointestinal cancer,98,65,33
Feb-23,EAST SUSSEX HEALTHCARE NHS TRUST,Suspected upper gastrointestinal cancer,149,127,22
Feb-23,SURREY AND SUSSEX HEALTHCARE NHS TRUST,Suspected upper gastrointestinal cancer,169,102,67
Feb-23,SURREY AND SUSSEX HEALTHCARE NHS TRUST,Suspected skin cancer,371,336,35
Feb-23,ASHFORD AND ST PETER'S HOSPITALS NHS FOUNDATION TRUST,Suspected urological malignancies (excluding testicular),111,94,17
Feb-23,UNIVERSITY HOSPITALS SUSSEX NHS FOUNDATION TRUST,Suspected upper gastrointestinal cancer,327,217,110
Feb-23,FRIMLEY HEALTH NHS FOUNDATION TRUST,Suspected urological malignancies (excluding testicular),203,132,71
Feb-23,FRIMLEY HEALTH NHS FOUNDATION TRUST,Suspected upper gastrointestinal cancer,220,141,79
Feb-23,ROYAL SURREY COUNTY HOSPITAL NHS FOUNDATION TRUST,Suspected upper gastrointestinal cancer,64,61,3
Feb-23,ROYAL SURREY COUNTY HOSPITAL NHS FOUNDATION TRUST,Suspected urological malignancies (excluding testicular),74,68,6
Feb-23,SURREY AND SUSSEX HEALTHCARE NHS TRUST,Suspected urological malignancies (excluding testicular),176,102,74
Feb-23,UNIVERSITY HOSPITALS SUSSEX NHS FOUNDATION TRUST,Suspected urological malignancies (excluding testicular),466,244,222
Feb-23,EAST SUSSEX HEALTHCARE NHS TRUST,Suspected urological malignancies (excluding testicular),188,126,62
Mar-23,ROYAL SURREY COUNTY HOSPITAL NHS FOUNDATION TRUST,Suspected breast cancer,237,233,4
Mar-23,FRIMLEY HEALTH NHS FOUNDATION TRUST,Suspected breast cancer,604,469,135
Mar-23,EAST SUSSEX HEALTHCARE NHS TRUST,Suspected breast cancer,254,191,63
Mar-23,ASHFORD AND ST PETER'S HOSPITALS NHS FOUNDATION TRUST,Suspected breast cancer,244,218,26
Mar-23,SURREY AND SUSSEX HEALTHCARE NHS TRUST,Suspected breast cancer,310,172,138
Mar-23,UNIVERSITY HOSPITALS SUSSEX NHS FOUNDATION TRUST,Suspected breast cancer,726,651,75
Mar-23,FRIMLEY HEALTH NHS FOUNDATION TRUST,Suspected gynaecological cancer,227,121,106
Mar-23,ROYAL SURREY COUNTY HOSPITAL NHS FOUNDATION TRUST,Suspected gynaecological cancer,46,38,8
Mar-23,EAST SUSSEX HEALTHCARE NHS TRUST,Suspected gynaecological cancer,228,157,71
Mar-23,ASHFORD AND ST PETER'S HOSPITALS NHS FOUNDATION TRUST,Suspected gynaecological cancer,162,99,63
Mar-23,SURREY AND SUSSEX HEALTHCARE NHS TRUST,Suspected gynaecological cancer,240,126,114
Mar-23,UNIVERSITY HOSPITALS SUSSEX NHS FOUNDATION TRUST,Suspected gynaecological cancer,445,286,159
Mar-23,FRIMLEY HEALTH NHS FOUNDATION TRUST,Suspected head & neck cancer,247,188,59
Mar-23,ROYAL SURREY COUNTY HOSPITAL NHS FOUNDATION TRUST,Suspected head & neck cancer,175,166,9
Mar-23,SURREY AND SUSSEX HEALTHCARE NHS TRUST,Suspected head & neck cancer,141,106,35
Mar-23,EAST SUSSEX HEALTHCARE NHS TRUST,Suspected head & neck cancer,265,188,77
Mar-23,QUEEN VICTORIA HOSPITAL NHS FOUNDATION TRUST,Suspected head & neck cancer,262,229,33
Mar-23,FRIMLEY HEALTH NHS FOUNDATION TRUST,Suspected lower gastrointestinal cancer,626,219,407
Mar-23,SURREY AND SUSSEX HEALTHCARE NHS TRUST,Suspected lower gastrointestinal cancer,527,318,209
Mar-23,EAST SUSSEX HEALTHCARE NHS TRUST,Suspected lower gastrointestinal cancer,527,390,137
Mar-23,UNIVERSITY HOSPITALS SUSSEX NHS FOUNDATION TRUST,Suspected head & neck cancer,513,346,167
Mar-23,ASHFORD AND ST PETER'S HOSPITALS NHS FOUNDATION TRUST,Suspected head & neck cancer,160,130,30
Mar-23,ROYAL SURREY COUNTY HOSPITAL NHS FOUNDATION TRUST,Suspected lower gastrointestinal cancer,274,235,39
Mar-23,ASHFORD AND ST PETER'S HOSPITALS NHS FOUNDATION TRUST,Suspected lower gastrointestinal cancer,343,284,59
Mar-23,UNIVERSITY HOSPITALS SUSSEX NHS FOUNDATION TRUST,Suspected lower gastrointestinal cancer,1130,665,465
Mar-23,ROYAL SURREY COUNTY HOSPITAL NHS FOUNDATION TRUST,Suspected lung cancer,16,15,1
Mar-23,FRIMLEY HEALTH NHS FOUNDATION TRUST,Suspected lung cancer,108,87,21
Mar-23,ASHFORD AND ST PETER'S HOSPITALS NHS FOUNDATION TRUST,Suspected lung cancer,26,17,9
Mar-23,SURREY AND SUSSEX HEALTHCARE NHS TRUST,Suspected lung cancer,72,62,10
Mar-23,ROYAL SURREY COUNTY HOSPITAL NHS FOUNDATION TRUST,Suspected skin cancer,19,17,2
Mar-23,EAST SUSSEX HEALTHCARE NHS TRUST,Suspected lung cancer,57,38,19
Mar-23,UNIVERSITY HOSPITALS SUSSEX NHS FOUNDATION TRUST,Suspected lung cancer,89,72,17
Mar-23,ASHFORD AND ST PETER'S HOSPITALS NHS FOUNDATION TRUST,Suspected skin cancer,421,392,29
Mar-23,QUEEN VICTORIA HOSPITAL NHS FOUNDATION TRUST,Suspected skin cancer,210,180,30
Mar-23,FRIMLEY HEALTH NHS FOUNDATION TRUST,Suspected skin cancer,529,441,88
Mar-23,ROYAL SURREY COUNTY HOSPITAL NHS FOUNDATION TRUST,Suspected upper gastrointestinal cancer,73,60,13
Mar-23,EAST SUSSEX HEALTHCARE NHS TRUST,Suspected skin cancer,561,517,44
Mar-23,UNIVERSITY HOSPITALS SUSSEX NHS FOUNDATION TRUST,Suspected skin cancer,914,846,68
Mar-23,SURREY AND SUSSEX HEALTHCARE NHS TRUST,Suspected skin cancer,451,431,20
Mar-23,FRIMLEY HEALTH NHS FOUNDATION TRUST,Suspected upper gastrointestinal cancer,223,129,94
Mar-23,UNIVERSITY HOSPITALS SUSSEX NHS FOUNDATION TRUST,Suspected upper gastrointestinal cancer,383,270,113
Mar-23,ROYAL SURREY COUNTY HOSPITAL NHS FOUNDATION TRUST,Suspected urological malignancies (excluding testicular),98,93,5
Mar-23,ASHFORD AND ST PETER'S HOSPITALS NHS FOUNDATION TRUST,Suspected urological malignancies (excluding testicular),128,108,20
Mar-23,EAST SUSSEX HEALTHCARE NHS TRUST,Suspected upper gastrointestinal cancer,158,133,25
Mar-23,ASHFORD AND ST PETER'S HOSPITALS NHS FOUNDATION TRUST,Suspected upper gastrointestinal cancer,122,65,57
Mar-23,SURREY AND SUSSEX HEALTHCARE NHS TRUST,Suspected upper gastrointestinal cancer,172,131,41
Mar-23,FRIMLEY HEALTH NHS FOUNDATION TRUST,Suspected urological malignancies (excluding testicular),247,158,89
Mar-23,SURREY AND SUSSEX HEALTHCARE NHS TRUST,Suspected urological malignancies (excluding testicular),193,113,80
Mar-23,EAST SUSSEX HEALTHCARE NHS TRUST,Suspected urological malignancies (excluding testicular),171,108,63
Mar-23,UNIVERSITY HOSPITALS SUSSEX NHS FOUNDATION TRUST,Suspected urological malignancies (excluding testicular),510,241,269
Apr-23,ROYAL SURREY COUNTY HOSPITAL NHS FOUNDATION TRUST,Suspected breast cancer,181,168,13
Apr-23,FRIMLEY HEALTH NHS FOUNDATION TRUST,Suspected breast cancer,561,373,188
Apr-23,ASHFORD AND ST PETER'S HOSPITALS NHS FOUNDATION TRUST,Suspected breast cancer,226,196,30
Apr-23,EAST SUSSEX HEALTHCARE NHS TRUST,Suspected breast cancer,258,180,78
Apr-23,SURREY AND SUSSEX HEALTHCARE NHS TRUST,Suspected breast cancer,248,153,95
Apr-23,UNIVERSITY HOSPITALS SUSSEX NHS FOUNDATION TRUST,Suspected breast cancer,562,485,77
Apr-23,ROYAL SURREY COUNTY HOSPITAL NHS FOUNDATION TRUST,Suspected gynaecological cancer,35,32,3
Apr-23,FRIMLEY HEALTH NHS FOUNDATION TRUST,Suspected gynaecological cancer,189,116,73
Apr-23,EAST SUSSEX HEALTHCARE NHS TRUST,Suspected gynaecological cancer,219,124,95
Apr-23,ASHFORD AND ST PETER'S HOSPITALS NHS FOUNDATION TRUST,Suspected gynaecological cancer,117,80,37
Apr-23,SURREY AND SUSSEX HEALTHCARE NHS TRUST,Suspected gynaecological cancer,178,104,74
Apr-23,UNIVERSITY HOSPITALS SUSSEX NHS FOUNDATION TRUST,Suspected gynaecological cancer,459,241,218
Apr-23,SURREY AND SUSSEX HEALTHCARE NHS TRUST,Suspected head & neck cancer,124,87,37
Apr-23,ROYAL SURREY COUNTY HOSPITAL NHS FOUNDATION TRUST,Suspected lower gastrointestinal cancer,198,166,32
Apr-23,FRIMLEY HEALTH NHS FOUNDATION TRUST,Suspected lower gastrointestinal cancer,565,143,422
Apr-23,ROYAL SURREY COUNTY HOSPITAL NHS FOUNDATION TRUST,Suspected head & neck cancer,134,122,12
Apr-23,SURREY AND SUSSEX HEALTHCARE NHS TRUST,Suspected lower gastrointestinal cancer,416,212,204
Apr-23,FRIMLEY HEALTH NHS FOUNDATION TRUST,Suspected head & neck cancer,193,136,57
Apr-23,ROYAL SURREY COUNTY HOSPITAL NHS FOUNDATION TRUST,Suspected lung cancer,14,12,2
Apr-23,EAST SUSSEX HEALTHCARE NHS TRUST,Suspected head & neck cancer,214,147,67
Apr-23,ASHFORD AND ST PETER'S HOSPITALS NHS FOUNDATION TRUST,Suspected lower gastrointestinal cancer,369,303,66
Apr-23,QUEEN VICTORIA HOSPITAL NHS FOUNDATION TRUST,Suspected head & neck cancer,202,175,27
Apr-23,ASHFORD AND ST PETER'S HOSPITALS NHS FOUNDATION TRUST,Suspected head & neck cancer,133,107,26
Apr-23,EAST SUSSEX HEALTHCARE NHS TRUST,Suspected lower gastrointestinal cancer,440,324,116
Apr-23,FRIMLEY HEALTH NHS FOUNDATION TRUST,Suspected lung cancer,78,64,14
Apr-23,FRIMLEY HEALTH NHS FOUNDATION TRUST,Suspected skin cancer,356,292,64
Apr-23,UNIVERSITY HOSPITALS SUSSEX NHS FOUNDATION TRUST,Suspected head & neck cancer,406,274,132
Apr-23,ASHFORD AND ST PETER'S HOSPITALS NHS FOUNDATION TRUST,Suspected lung cancer,35,19,16
Apr-23,SURREY AND SUSSEX HEALTHCARE NHS TRUST,Suspected lung cancer,53,45,8
Apr-23,EAST SUSSEX HEALTHCARE NHS TRUST,Suspected lung cancer,63,38,25
Apr-23,QUEEN VICTORIA HOSPITAL NHS FOUNDATION TRUST,Suspected skin cancer,182,147,35
Apr-23,ASHFORD AND ST PETER'S HOSPITALS NHS FOUNDATION TRUST,Suspected skin cancer,351,313,38
Apr-23,UNIVERSITY HOSPITALS SUSSEX NHS FOUNDATION TRUST,Suspected lower gastrointestinal cancer,976,594,382
Apr-23,ROYAL SURREY COUNTY HOSPITAL NHS FOUNDATION TRUST,Suspected upper gastrointestinal cancer,63,49,14
Apr-23,UNIVERSITY HOSPITALS SUSSEX NHS FOUNDATION TRUST,Suspected lung cancer,68,56,12
Apr-23,ROYAL SURREY COUNTY HOSPITAL NHS FOUNDATION TRUST,Suspected skin cancer,6,6,0
Apr-23,FRIMLEY HEALTH NHS FOUNDATION TRUST,Suspected upper gastrointestinal cancer,216,155,61
Apr-23,ASHFORD AND ST PETER'S HOSPITALS NHS FOUNDATION TRUST,Suspected upper gastrointestinal cancer,91,50,41
Apr-23,EAST SUSSEX HEALTHCARE NHS TRUST,Suspected skin cancer,488,462,26
Apr-23,EAST SUSSEX HEALTHCARE NHS TRUST,Suspected upper gastrointestinal cancer,160,123,37
Apr-23,SURREY AND SUSSEX HEALTHCARE NHS TRUST,Suspected upper gastrointestinal cancer,188,142,46
Apr-23,ASHFORD AND ST PETER'S HOSPITALS NHS FOUNDATION TRUST,Suspected urological malignancies (excluding testicular),127,87,40
Apr-23,UNIVERSITY HOSPITALS SUSSEX NHS FOUNDATION TRUST,Suspected upper gastrointestinal cancer,310,213,97
Apr-23,SURREY AND SUSSEX HEALTHCARE NHS TRUST,Suspected skin cancer,424,412,12
Apr-23,UNIVERSITY HOSPITALS SUSSEX NHS FOUNDATION TRUST,Suspected skin cancer,832,756,76
Apr-23,FRIMLEY HEALTH NHS FOUNDATION TRUST,Suspected urological malignancies (excluding testicular),200,103,97
Apr-23,SURREY AND SUSSEX HEALTHCARE NHS TRUST,Suspected urological malignancies (excluding testicular),166,122,44
Apr-23,ROYAL SURREY COUNTY HOSPITAL NHS FOUNDATION TRUST,Suspected urological malignancies (excluding testicular),71,64,7
Apr-23,EAST SUSSEX HEALTHCARE NHS TRUST,Suspected urological malignancies (excluding testicular),151,80,71
Apr-23,UNIVERSITY HOSPITALS SUSSEX NHS FOUNDATION TRUST,Suspected urological malignancies (excluding testicular),371,201,170
May-23,FRIMLEY HEALTH NHS FOUNDATION TRUST,Suspected breast cancer,571,502,69
May-23,ROYAL SURREY COUNTY HOSPITAL NHS FOUNDATION TRUST,Suspected breast cancer,206,200,6
May-23,ASHFORD AND ST PETER'S HOSPITALS NHS FOUNDATION TRUST,Suspected breast cancer,193,158,35
May-23,EAST SUSSEX HEALTHCARE NHS TRUST,Suspected breast cancer,260,183,77
May-23,UNIVERSITY HOSPITALS SUSSEX NHS FOUNDATION TRUST,Suspected breast cancer,583,466,117
May-23,SURREY AND SUSSEX HEALTHCARE NHS TRUST,Suspected breast cancer,222,94,128
May-23,ROYAL SURREY COUNTY HOSPITAL NHS FOUNDATION TRUST,Suspected gynaecological cancer,39,31,8
May-23,ASHFORD AND ST PETER'S HOSPITALS NHS FOUNDATION TRUST,Suspected gynaecological cancer,140,81,59
May-23,SURREY AND SUSSEX HEALTHCARE NHS TRUST,Suspected gynaecological cancer,227,141,86
May-23,EAST SUSSEX HEALTHCARE NHS TRUST,Suspected gynaecological cancer,224,160,64
May-23,UNIVERSITY HOSPITALS SUSSEX NHS FOUNDATION TRUST,Suspected gynaecological cancer,412,207,205
May-23,FRIMLEY HEALTH NHS FOUNDATION TRUST,Suspected gynaecological cancer,213,130,83
May-23,ROYAL SURREY COUNTY HOSPITAL NHS FOUNDATION TRUST,Suspected head & neck cancer,160,143,17
May-23,FRIMLEY HEALTH NHS FOUNDATION TRUST,Suspected head & neck cancer,230,177,53
May-23,UNIVERSITY HOSPITALS SUSSEX NHS FOUNDATION TRUST,Suspected head & neck cancer,388,243,145
May-23,ROYAL SURREY COUNTY HOSPITAL NHS FOUNDATION TRUST,Suspected lower gastrointestinal cancer,252,218,34
May-23,FRIMLEY HEALTH NHS FOUNDATION TRUST,Suspected lower gastrointestinal cancer,624,293,331
May-23,ASHFORD AND ST PETER'S HOSPITALS NHS FOUNDATION TRUST,Suspected head & neck cancer,142,98,44
May-23,QUEEN VICTORIA HOSPITAL NHS FOUNDATION TRUST,Suspected head & neck cancer,244,207,37
May-23,SURREY AND SUSSEX HEALTHCARE NHS TRUST,Suspected head & neck cancer,119,82,37
May-23,EAST SUSSEX HEALTHCARE NHS TRUST,Suspected head & neck cancer,189,132,57
May-23,ASHFORD AND ST PETER'S HOSPITALS NHS FOUNDATION TRUST,Suspected lower gastrointestinal cancer,358,286,72
May-23,SURREY AND SUSSEX HEALTHCARE NHS TRUST,Suspected lower gastrointestinal cancer,543,355,188
May-23,FRIMLEY HEALTH NHS FOUNDATION TRUST,Suspected lung cancer,88,64,24
May-23,EAST SUSSEX HEALTHCARE NHS TRUST,Suspected lower gastrointestinal cancer,444,328,116
May-23,ROYAL SURREY COUNTY HOSPITAL NHS FOUNDATION TRUST,Suspected lung cancer,34,28,6
May-23,UNIVERSITY HOSPITALS SUSSEX NHS FOUNDATION TRUST,Suspected lower gastrointestinal cancer,1061,601,460
May-23,ASHFORD AND ST PETER'S HOSPITALS NHS FOUNDATION TRUST,Suspected lung cancer,33,21,12
May-23,SURREY AND SUSSEX HEALTHCARE NHS TRUST,Suspected lung cancer,48,43,5
May-23,EAST SUSSEX HEALTHCARE NHS TRUST,Suspected skin cancer,529,490,39
May-23,EAST SUSSEX HEALTHCARE NHS TRUST,Suspected lung cancer,54,34,20
May-23,UNIVERSITY HOSPITALS SUSSEX NHS FOUNDATION TRUST,Suspected lung cancer,65,54,11
May-23,ROYAL SURREY COUNTY HOSPITAL NHS FOUNDATION TRUST,Suspected skin cancer,7,7,0
May-23,QUEEN VICTORIA HOSPITAL NHS FOUNDATION TRUST,Suspected skin cancer,207,179,28
May-23,FRIMLEY HEALTH NHS FOUNDATION TRUST,Suspected skin cancer,468,413,55
May-23,SURREY AND SUSSEX HEALTHCARE NHS TRUST,Suspected skin cancer,438,409,29
May-23,ROYAL SURREY COUNTY HOSPITAL NHS FOUNDATION TRUST,Suspected upper gastrointestinal cancer,56,47,9
May-23,ASHFORD AND ST PETER'S HOSPITALS NHS FOUNDATION TRUST,Suspected skin cancer,475,441,34
May-23,UNIVERSITY HOSPITALS SUSSEX NHS FOUNDATION TRUST,Suspected skin cancer,1057,938,119
May-23,SURREY AND SUSSEX HEALTHCARE NHS TRUST,Suspected upper gastrointestinal cancer,164,137,27
May-23,ROYAL SURREY COUNTY HOSPITAL NHS FOUNDATION TRUST,Suspected urological malignancies (excluding testicular),105,89,16
May-23,FRIMLEY HEALTH NHS FOUNDATION TRUST,Suspected urological malignancies (excluding testicular),253,148,105
May-23,FRIMLEY HEALTH NHS FOUNDATION TRUST,Suspected upper gastrointestinal cancer,208,146,62
May-23,EAST SUSSEX HEALTHCARE NHS TRUST,Suspected upper gastrointestinal cancer,157,127,30
May-23,ASHFORD AND ST PETER'S HOSPITALS NHS FOUNDATION TRUST,Suspected upper gastrointestinal cancer,112,60,52
May-23,UNIVERSITY HOSPITALS SUSSEX NHS FOUNDATION TRUST,Suspected upper gastrointestinal cancer,320,194,126
May-23,SURREY AND SUSSEX HEALTHCARE NHS TRUST,Suspected urological malignancies (excluding testicular),170,113,57
May-23,UNIVERSITY HOSPITALS SUSSEX NHS FOUNDATION TRUST,Suspected urological malignancies (excluding testicular),434,229,205
May-23,EAST SUSSEX HEALTHCARE NHS TRUST,Suspected urological malignancies (excluding testicular),141,78,63
May-23,ASHFORD AND ST PETER'S HOSPITALS NHS FOUNDATION TRUST,Suspected urological malignancies (excluding testicular),130,106,24
Jun-23,ROYAL SURREY COUNTY HOSPITAL NHS FOUNDATION TRUST,Suspected breast cancer,205,200,5
Jun-23,FRIMLEY HEALTH NHS FOUNDATION TRUST,Suspected breast cancer,610,531,79
Jun-23,SURREY AND SUSSEX HEALTHCARE NHS TRUST,Suspected breast cancer,332,151,181
Jun-23,ASHFORD AND ST PETER'S HOSPITALS NHS FOUNDATION TRUST,Suspected breast cancer,287,228,59
Jun-23,EAST SUSSEX HEALTHCARE NHS TRUST,Suspected breast cancer,298,207,91
Jun-23,UNIVERSITY HOSPITALS SUSSEX NHS FOUNDATION TRUST,Suspected breast cancer,841,696,145
Jun-23,FRIMLEY HEALTH NHS FOUNDATION TRUST,Suspected gynaecological cancer,201,106,95
Jun-23,ROYAL SURREY COUNTY HOSPITAL NHS FOUNDATION TRUST,Suspected gynaecological cancer,40,24,16
Jun-23,ASHFORD AND ST PETER'S HOSPITALS NHS FOUNDATION TRUST,Suspected gynaecological cancer,153,91,62
Jun-23,SURREY AND SUSSEX HEALTHCARE NHS TRUST,Suspected head & neck cancer,128,101,27
Jun-23,SURREY AND SUSSEX HEALTHCARE NHS TRUST,Suspected gynaecological cancer,225,134,91
Jun-23,UNIVERSITY HOSPITALS SUSSEX NHS FOUNDATION TRUST,Suspected gynaecological cancer,438,168,270
Jun-23,EAST SUSSEX HEALTHCARE NHS TRUST,Suspected gynaecological cancer,212,151,61
Jun-23,ROYAL SURREY COUNTY HOSPITAL NHS FOUNDATION TRUST,Suspected head & neck cancer,147,129,18
Jun-23,QUEEN VICTORIA HOSPITAL NHS FOUNDATION TRUST,Suspected head & neck cancer,221,190,31
Jun-23,UNIVERSITY HOSPITALS SUSSEX NHS FOUNDATION TRUST,Suspected head & neck cancer,496,305,191
Jun-23,ASHFORD AND ST PETER'S HOSPITALS NHS FOUNDATION TRUST,Suspected head & neck cancer,177,144,33
Jun-23,ASHFORD AND ST PETER'S HOSPITALS NHS FOUNDATION TRUST,Suspected lower gastrointestinal cancer,335,279,56
Jun-23,SURREY AND SUSSEX HEALTHCARE NHS TRUST,Suspected lower gastrointestinal cancer,428,352,76
Jun-23,EAST SUSSEX HEALTHCARE NHS TRUST,Suspected lower gastrointestinal cancer,428,321,107
Jun-23,FRIMLEY HEALTH NHS FOUNDATION TRUST,Suspected lower gastrointestinal cancer,520,293,227
Jun-23,FRIMLEY HEALTH NHS FOUNDATION TRUST,Suspected head & neck cancer,277,213,64
Jun-23,UNIVERSITY HOSPITALS SUSSEX NHS FOUNDATION TRUST,Suspected lower gastrointestinal cancer,1041,640,401
Jun-23,ROYAL SURREY COUNTY HOSPITAL NHS FOUNDATION TRUST,Suspected lung cancer,19,15,4
Jun-23,EAST SUSSEX HEALTHCARE NHS TRUST,Suspected lung cancer,53,39,14
Jun-23,ROYAL SURREY COUNTY HOSPITAL NHS FOUNDATION TRUST,Suspected lower gastrointestinal cancer,245,209,36
Jun-23,EAST SUSSEX HEALTHCARE NHS TRUST,Suspected head & neck cancer,242,159,83
Jun-23,FRIMLEY HEALTH NHS FOUNDATION TRUST,Suspected skin cancer,489,438,51
Jun-23,FRIMLEY HEALTH NHS FOUNDATION TRUST,Suspected lung cancer,79,53,26
Jun-23,ROYAL SURREY COUNTY HOSPITAL NHS FOUNDATION TRUST,Suspected skin cancer,10,10,0
Jun-23,QUEEN VICTORIA HOSPITAL NHS FOUNDATION TRUST,Suspected skin cancer,268,234,34
Jun-23,SURREY AND SUSSEX HEALTHCARE NHS TRUST,Suspected lung cancer,40,31,9
Jun-23,ASHFORD AND ST PETER'S HOSPITALS NHS FOUNDATION TRUST,Suspected skin cancer,578,546,32
Jun-23,SURREY AND SUSSEX HEALTHCARE NHS TRUST,Suspected skin cancer,581,559,22
Jun-23,EAST SUSSEX HEALTHCARE NHS TRUST,Suspected skin cancer,446,422,24
Jun-23,UNIVERSITY HOSPITALS SUSSEX NHS FOUNDATION TRUST,Suspected skin cancer,1121,979,142
Jun-23,UNIVERSITY HOSPITALS SUSSEX NHS FOUNDATION TRUST,Suspected lung cancer,73,65,8
Jun-23,ASHFORD AND ST PETER'S HOSPITALS NHS FOUNDATION TRUST,Suspected lung cancer,34,24,10
Jun-23,ROYAL SURREY COUNTY HOSPITAL NHS FOUNDATION TRUST,Suspected upper gastrointestinal cancer,74,55,19
Jun-23,SURREY AND SUSSEX HEALTHCARE NHS TRUST,Suspected upper gastrointestinal cancer,203,178,25
Jun-23,FRIMLEY HEALTH NHS FOUNDATION TRUST,Suspected urological malignancies (excluding testicular),215,140,75
Jun-23,ASHFORD AND ST PETER'S HOSPITALS NHS FOUNDATION TRUST,Suspected upper gastrointestinal cancer,103,58,45
Jun-23,EAST SUSSEX HEALTHCARE NHS TRUST,Suspected upper gastrointestinal cancer,125,102,23
Jun-23,UNIVERSITY HOSPITALS SUSSEX NHS FOUNDATION TRUST,Suspected upper gastrointestinal cancer,331,245,86
Jun-23,ROYAL SURREY COUNTY HOSPITAL NHS FOUNDATION TRUST,Suspected urological malignancies (excluding testicular),72,66,6
Jun-23,FRIMLEY HEALTH NHS FOUNDATION TRUST,Suspected upper gastrointestinal cancer,184,128,56
Jun-23,EAST SUSSEX HEALTHCARE NHS TRUST,Suspected urological malignancies (excluding testicular),187,120,67
Jun-23,SURREY AND SUSSEX HEALTHCARE NHS TRUST,Suspected urological malignancies (excluding testicular),162,115,47
Jun-23,UNIVERSITY HOSPITALS SUSSEX NHS FOUNDATION TRUST,Suspected urological malignancies (excluding testicular),446,253,193
Jun-23,ASHFORD AND ST PETER'S HOSPITALS NHS FOUNDATION TRUST,Suspected urological malignancies (excluding testicular),134,107,27
Jul-23,ROYAL SURREY COUNTY HOSPITAL NHS FOUNDATION TRUST,Suspected breast cancer,240,233,7
Jul-23,FRIMLEY HEALTH NHS FOUNDATION TRUST,Suspected breast cancer,626,565,61
Jul-23,UNIVERSITY HOSPITALS SUSSEX NHS FOUNDATION TRUST,Suspected breast cancer,582,454,128
Jul-23,SURREY AND SUSSEX HEALTHCARE NHS TRUST,Suspected breast cancer,320,138,182
Jul-23,ASHFORD AND ST PETER'S HOSPITALS NHS FOUNDATION TRUST,Suspected breast cancer,228,178,50
Jul-23,EAST SUSSEX HEALTHCARE NHS TRUST,Suspected breast cancer,257,128,129
Jul-23,ROYAL SURREY COUNTY HOSPITAL NHS FOUNDATION TRUST,Suspected gynaecological cancer,99,62,37
Jul-23,FRIMLEY HEALTH NHS FOUNDATION TRUST,Suspected gynaecological cancer,209,115,94
Jul-23,SURREY AND SUSSEX HEALTHCARE NHS TRUST,Suspected gynaecological cancer,280,175,105
Jul-23,ASHFORD AND ST PETER'S HOSPITALS NHS FOUNDATION TRUST,Suspected gynaecological cancer,165,109,56
Jul-23,EAST SUSSEX HEALTHCARE NHS TRUST,Suspected gynaecological cancer,232,164,68
Jul-23,UNIVERSITY HOSPITALS SUSSEX NHS FOUNDATION TRUST,Suspected gynaecological cancer,360,126,234
Jul-23,ROYAL SURREY COUNTY HOSPITAL NHS FOUNDATION TRUST,Suspected head & neck cancer,150,108,42
Jul-23,FRIMLEY HEALTH NHS FOUNDATION TRUST,Suspected head & neck cancer,285,231,54
Jul-23,ASHFORD AND ST PETER'S HOSPITALS NHS FOUNDATION TRUST,Suspected head & neck cancer,123,103,20
Jul-23,SURREY AND SUSSEX HEALTHCARE NHS TRUST,Suspected head & neck cancer,86,61,25
Jul-23,EAST SUSSEX HEALTHCARE NHS TRUST,Suspected head & neck cancer,250,196,54
Jul-23,QUEEN VICTORIA HOSPITAL NHS FOUNDATION TRUST,Suspected head & neck cancer,260,225,35
Jul-23,FRIMLEY HEALTH NHS FOUNDATION TRUST,Suspected lower gastrointestinal cancer,562,315,247
Jul-23,UNIVERSITY HOSPITALS SUSSEX NHS FOUNDATION TRUST,Suspected head & neck cancer,416,279,137
Jul-23,ASHFORD AND ST PETER'S HOSPITALS NHS FOUNDATION TRUST,Suspected lower gastrointestinal cancer,314,271,43
Jul-23,SURREY AND SUSSEX HEALTHCARE NHS TRUST,Suspected lower gastrointestinal cancer,466,382,84
Jul-23,ROYAL SURREY COUNTY HOSPITAL NHS FOUNDATION TRUST,Suspected lower gastrointestinal cancer,251,210,41
Jul-23,EAST SUSSEX HEALTHCARE NHS TRUST,Suspected lower gastrointestinal cancer,415,290,125
Jul-23,ROYAL SURREY COUNTY HOSPITAL NHS FOUNDATION TRUST,Suspected lung cancer,9,6,3
Jul-23,UNIVERSITY HOSPITALS SUSSEX NHS FOUNDATION TRUST,Suspected lower gastrointestinal cancer,897,495,402
Jul-23,FRIMLEY HEALTH NHS FOUNDATION TRUST,Suspected lung cancer,67,50,17
Jul-23,SURREY AND SUSSEX HEALTHCARE NHS TRUST,Suspected lung cancer,45,41,4
Jul-23,ASHFORD AND ST PETER'S HOSPITALS NHS FOUNDATION TRUST,Suspected lung cancer,25,17,8
Jul-23,UNIVERSITY HOSPITALS SUSSEX NHS FOUNDATION TRUST,Suspected lung cancer,57,44,13
Jul-23,EAST SUSSEX HEALTHCARE NHS TRUST,Suspected lung cancer,40,26,14
Jul-23,QUEEN VICTORIA HOSPITAL NHS FOUNDATION TRUST,Suspected skin cancer,256,222,34
Jul-23,FRIMLEY HEALTH NHS FOUNDATION TRUST,Suspected skin cancer,548,511,37
Jul-23,ROYAL SURREY COUNTY HOSPITAL NHS FOUNDATION TRUST,Suspected skin cancer,6,2,4
Jul-23,ASHFORD AND ST PETER'S HOSPITALS NHS FOUNDATION TRUST,Suspected skin cancer,638,607,31
Jul-23,SURREY AND SUSSEX HEALTHCARE NHS TRUST,Suspected skin cancer,635,609,26
Jul-23,EAST SUSSEX HEALTHCARE NHS TRUST,Suspected skin cancer,591,557,34
Jul-23,UNIVERSITY HOSPITALS SUSSEX NHS FOUNDATION TRUST,Suspected skin cancer,1268,995,273
Jul-23,ROYAL SURREY COUNTY HOSPITAL NHS FOUNDATION TRUST,Suspected upper gastrointestinal cancer,70,56,14
Jul-23,SURREY AND SUSSEX HEALTHCARE NHS TRUST,Suspected upper gastrointestinal cancer,154,130,24
Jul-23,FRIMLEY HEALTH NHS FOUNDATION TRUST,Suspected upper gastrointestinal cancer,217,148,69
Jul-23,UNIVERSITY HOSPITALS SUSSEX NHS FOUNDATION TRUST,Suspected upper gastrointestinal cancer,316,214,102
Jul-23,ROYAL SURREY COUNTY HOSPITAL NHS FOUNDATION TRUST,Suspected urological malignancies (excluding testicular),80,77,3
Jul-23,SURREY AND SUSSEX HEALTHCARE NHS TRUST,Suspected urological malignancies (excluding testicular),159,106,53
Jul-23,EAST SUSSEX HEALTHCARE NHS TRUST,Suspected urological malignancies (excluding testicular),175,103,72
Jul-23,FRIMLEY HEALTH NHS FOUNDATION TRUST,Suspected urological malignancies (excluding testicular),187,127,60
Jul-23,ASHFORD AND ST PETER'S HOSPITALS NHS FOUNDATION TRUST,Suspected urological malignancies (excluding testicular),101,79,22
Jul-23,UNIVERSITY HOSPITALS SUSSEX NHS FOUNDATION TRUST,Suspected urological malignancies (excluding testicular),394,235,159
Jul-23,ASHFORD AND ST PETER'S HOSPITALS NHS FOUNDATION TRUST,Suspected upper gastrointestinal cancer,125,62,63
Jul-23,EAST SUSSEX HEALTHCARE NHS TRUST,Suspected upper gastrointestinal cancer,148,114,34
Aug-23,ROYAL SURREY COUNTY HOSPITAL NHS FOUNDATION TRUST,Suspected breast cancer,234,219,15
Aug-23,FRIMLEY HEALTH NHS FOUNDATION TRUST,Suspected breast cancer,542,457,85
Aug-23,SURREY AND SUSSEX HEALTHCARE NHS TRUST,Suspected breast cancer,328,164,164
Aug-23,ASHFORD AND ST PETER'S HOSPITALS NHS FOUNDATION TRUST,Suspected breast cancer,245,217,28
Aug-23,EAST SUSSEX HEALTHCARE NHS TRUST,Suspected breast cancer,307,172,135
Aug-23,UNIVERSITY HOSPITALS SUSSEX NHS FOUNDATION TRUST,Suspected breast cancer,655,372,283
Aug-23,ROYAL SURREY COUNTY HOSPITAL NHS FOUNDATION TRUST,Suspected gynaecological cancer,81,56,25
Aug-23,FRIMLEY HEALTH NHS FOUNDATION TRUST,Suspected gynaecological cancer,230,132,98
Aug-23,ASHFORD AND ST PETER'S HOSPITALS NHS FOUNDATION TRUST,Suspected gynaecological cancer,162,109,53
Aug-23,SURREY AND SUSSEX HEALTHCARE NHS TRUST,Suspected gynaecological cancer,281,218,63
Aug-23,UNIVERSITY HOSPITALS SUSSEX NHS FOUNDATION TRUST,Suspected gynaecological cancer,387,55,332
Aug-23,EAST SUSSEX HEALTHCARE NHS TRUST,Suspected gynaecological cancer,237,164,73
Aug-23,FRIMLEY HEALTH NHS FOUNDATION TRUST,Suspected head & neck cancer,258,207,51
Aug-23,ROYAL SURREY COUNTY HOSPITAL NHS FOUNDATION TRUST,Suspected head & neck cancer,161,128,33
Aug-23,ASHFORD AND ST PETER'S HOSPITALS NHS FOUNDATION TRUST,Suspected head & neck cancer,128,109,19
Aug-23,SURREY AND SUSSEX HEALTHCARE NHS TRUST,Suspected head & neck cancer,115,78,37
Aug-23,QUEEN VICTORIA HOSPITAL NHS FOUNDATION TRUST,Suspected head & neck cancer,253,202,51
Aug-23,ROYAL SURREY COUNTY HOSPITAL NHS FOUNDATION TRUST,Suspected lower gastrointestinal cancer,237,196,41
Aug-23,FRIMLEY HEALTH NHS FOUNDATION TRUST,Suspected lower gastrointestinal cancer,551,299,252
Aug-23,EAST SUSSEX HEALTHCARE NHS TRUST,Suspected head & neck cancer,233,157,76
Aug-23,SURREY AND SUSSEX HEALTHCARE NHS TRUST,Suspected lower gastrointestinal cancer,411,334,77
Aug-23,ASHFORD AND ST PETER'S HOSPITALS NHS FOUNDATION TRUST,Suspected lower gastrointestinal cancer,310,269,41
Aug-23,ROYAL SURREY COUNTY HOSPITAL NHS FOUNDATION TRUST,Suspected lung cancer,19,14,5
Aug-23,UNIVERSITY HOSPITALS SUSSEX NHS FOUNDATION TRUST,Suspected lower gastrointestinal cancer,953,406,547
Aug-23,UNIVERSITY HOSPITALS SUSSEX NHS FOUNDATION TRUST,Suspected head & neck cancer,506,338,168
Aug-23,ASHFORD AND ST PETER'S HOSPITALS NHS FOUNDATION TRUST,Suspected lung cancer,20,12,8
Aug-23,FRIMLEY HEALTH NHS FOUNDATION TRUST,Suspected lung cancer,62,35,27
Aug-23,EAST SUSSEX HEALTHCARE NHS TRUST,Suspected lower gastrointestinal cancer,494,339,155
Aug-23,UNIVERSITY HOSPITALS SUSSEX NHS FOUNDATION TRUST,Suspected lung cancer,75,60,15
Aug-23,SURREY AND SUSSEX HEALTHCARE NHS TRUST,Suspected lung cancer,44,39,5
Aug-23,EAST SUSSEX HEALTHCARE NHS TRUST,Suspected lung cancer,51,32,19
Aug-23,QUEEN VICTORIA HOSPITAL NHS FOUNDATION TRUST,Suspected skin cancer,236,159,77
Aug-23,FRIMLEY HEALTH NHS FOUNDATION TRUST,Suspected skin cancer,489,453,36
Aug-23,EAST SUSSEX HEALTHCARE NHS TRUST,Suspected skin cancer,804,749,55
Aug-23,ROYAL SURREY COUNTY HOSPITAL NHS FOUNDATION TRUST,Suspected upper gastrointestinal cancer,74,59,15
Aug-23,ROYAL SURREY COUNTY HOSPITAL NHS FOUNDATION TRUST,Suspected skin cancer,24,21,3
Aug-23,SURREY AND SUSSEX HEALTHCARE NHS TRUST,Suspected skin cancer,609,574,35
Aug-23,ASHFORD AND ST PETER'S HOSPITALS NHS FOUNDATION TRUST,Suspected skin cancer,695,654,41
Aug-23,EAST SUSSEX HEALTHCARE NHS TRUST,Suspected upper gastrointestinal cancer,188,159,29
Aug-23,UNIVERSITY HOSPITALS SUSSEX NHS FOUNDATION TRUST,Suspected skin cancer,1242,797,445
Aug-23,FRIMLEY HEALTH NHS FOUNDATION TRUST,Suspected upper gastrointestinal cancer,171,132,39
Aug-23,SURREY AND SUSSEX HEALTHCARE NHS TRUST,Suspected urological malignancies (excluding testicular),181,110,71
Aug-23,UNIVERSITY HOSPITALS SUSSEX NHS FOUNDATION TRUST,Suspected urological malignancies (excluding testicular),464,266,198
Aug-23,ROYAL SURREY COUNTY HOSPITAL NHS FOUNDATION TRUST,Suspected urological malignancies (excluding testicular),101,94,7
Aug-23,FRIMLEY HEALTH NHS FOUNDATION TRUST,Suspected urological malignancies (excluding testicular),202,138,64
Aug-23,ASHFORD AND ST PETER'S HOSPITALS NHS FOUNDATION TRUST,Suspected urological malignancies (excluding testicular),150,118,32
Aug-23,ASHFORD AND ST PETER'S HOSPITALS NHS FOUNDATION TRUST,Suspected upper gastrointestinal cancer,120,78,42
Aug-23,SURREY AND SUSSEX HEALTHCARE NHS TRUST,Suspected upper gastrointestinal cancer,157,128,29
Aug-23,UNIVERSITY HOSPITALS SUSSEX NHS FOUNDATION TRUST,Suspected upper gastrointestinal cancer,336,215,121
Aug-23,EAST SUSSEX HEALTHCARE NHS TRUST,Suspected urological malignancies (excluding testicular),216,137,79
Sep-23,ROYAL SURREY COUNTY HOSPITAL NHS FOUNDATION TRUST,Suspected breast cancer,187,184,3
Sep-23,FRIMLEY HEALTH NHS FOUNDATION TRUST,Suspected breast cancer,512,429,83
Sep-23,ASHFORD AND ST PETER'S HOSPITALS NHS FOUNDATION TRUST,Suspected breast cancer,248,209,39
Sep-23,QUEEN VICTORIA HOSPITAL NHS FOUNDATION TRUST,Suspected breast cancer,1,1,0
Sep-23,UNIVERSITY HOSPITALS SUSSEX NHS FOUNDATION TRUST,Suspected breast cancer,639,354,285
Sep-23,SURREY AND SUSSEX HEALTHCARE NHS TRUST,Suspected breast cancer,315,144,171
Sep-23,EAST SUSSEX HEALTHCARE NHS TRUST,Suspected breast cancer,298,147,151
Sep-23,ASHFORD AND ST PETER'S HOSPITALS NHS FOUNDATION TRUST,Suspected gynaecological cancer,130,83,47
Sep-23,FRIMLEY HEALTH NHS FOUNDATION TRUST,Suspected gynaecological cancer,232,114,118
Sep-23,UNIVERSITY HOSPITALS SUSSEX NHS FOUNDATION TRUST,Suspected gynaecological cancer,537,142,395
Sep-23,EAST SUSSEX HEALTHCARE NHS TRUST,Suspected gynaecological cancer,199,125,74
Sep-23,ROYAL SURREY COUNTY HOSPITAL NHS FOUNDATION TRUST,Suspected gynaecological cancer,55,33,22
Sep-23,SURREY AND SUSSEX HEALTHCARE NHS TRUST,Suspected gynaecological cancer,248,161,87
Sep-23,FRIMLEY HEALTH NHS FOUNDATION TRUST,Suspected head & neck cancer,296,233,63
Sep-23,QUEEN VICTORIA HOSPITAL NHS FOUNDATION TRUST,Suspected head & neck cancer,209,158,51
Sep-23,ASHFORD AND ST PETER'S HOSPITALS NHS FOUNDATION TRUST,Suspected head & neck cancer,132,105,27
Sep-23,UNIVERSITY HOSPITALS SUSSEX NHS FOUNDATION TRUST,Suspected head & neck cancer,459,285,174
Sep-23,ROYAL SURREY COUNTY HOSPITAL NHS FOUNDATION TRUST,Suspected head & neck cancer,143,115,28
Sep-23,ASHFORD AND ST PETER'S HOSPITALS NHS FOUNDATION TRUST,Suspected lower gastrointestinal cancer,320,256,64
Sep-23,SURREY AND SUSSEX HEALTHCARE NHS TRUST,Suspected lower gastrointestinal cancer,426,357,69
Sep-23,UNIVERSITY HOSPITALS SUSSEX NHS FOUNDATION TRUST,Suspected lower gastrointestinal cancer,954,380,574
Sep-23,ROYAL SURREY COUNTY HOSPITAL NHS FOUNDATION TRUST,Suspected lower gastrointestinal cancer,206,168,38
Sep-23,SURREY AND SUSSEX HEALTHCARE NHS TRUST,Suspected head & neck cancer,160,98,62
Sep-23,FRIMLEY HEALTH NHS FOUNDATION TRUST,Suspected lower gastrointestinal cancer,496,256,240
Sep-23,EAST SUSSEX HEALTHCARE NHS TRUST,Suspected head & neck cancer,266,208,58
Sep-23,EAST SUSSEX HEALTHCARE NHS TRUST,Suspected lower gastrointestinal cancer,469,345,124
Sep-23,ROYAL SURREY COUNTY HOSPITAL NHS FOUNDATION TRUST,Suspected lung cancer,21,17,4
Sep-23,FRIMLEY HEALTH NHS FOUNDATION TRUST,Suspected lung cancer,61,34,27
Sep-23,UNIVERSITY HOSPITALS SUSSEX NHS FOUNDATION TRUST,Suspected lung cancer,55,40,15
Sep-23,ASHFORD AND ST PETER'S HOSPITALS NHS FOUNDATION TRUST,Suspected skin cancer,653,589,64
Sep-23,ASHFORD AND ST PETER'S HOSPITALS NHS FOUNDATION TRUST,Suspected lung cancer,16,10,6
Sep-23,SURREY AND SUSSEX HEALTHCARE NHS TRUST,Suspected lung cancer,51,43,8
Sep-23,EAST SUSSEX HEALTHCARE NHS TRUST,Suspected lung cancer,42,24,18
Sep-23,FRIMLEY HEALTH NHS FOUNDATION TRUST,Suspected skin cancer,577,506,71
Sep-23,QUEEN VICTORIA HOSPITAL NHS FOUNDATION TRUST,Suspected skin cancer,228,191,37
Sep-23,ROYAL SURREY COUNTY HOSPITAL NHS FOUNDATION TRUST,Suspected upper gastrointestinal cancer,81,73,8
Sep-23,SURREY AND SUSSEX HEALTHCARE NHS TRUST,Suspected skin cancer,703,662,41
Sep-23,EAST SUSSEX HEALTHCARE NHS TRUST,Suspected skin cancer,672,631,41
Sep-23,ROYAL SURREY COUNTY HOSPITAL NHS FOUNDATION TRUST,Suspected skin cancer,20,17,3
Sep-23,UNIVERSITY HOSPITALS SUSSEX NHS FOUNDATION TRUST,Suspected skin cancer,1331,712,619
Sep-23,EAST SUSSEX HEALTHCARE NHS TRUST,Suspected upper gastrointestinal cancer,145,126,19
Sep-23,SURREY AND SUSSEX HEALTHCARE NHS TRUST,Suspected upper gastrointestinal cancer,180,148,32
Sep-23,EAST SUSSEX HEALTHCARE NHS TRUST,Suspected urological malignancies (excluding testicular),150,80,70
Sep-23,SURREY AND SUSSEX HEALTHCARE NHS TRUST,Suspected urological malignancies (excluding testicular),185,139,46
Sep-23,ASHFORD AND ST PETER'S HOSPITALS NHS FOUNDATION TRUST,Suspected upper gastrointestinal cancer,112,56,56
Sep-23,FRIMLEY HEALTH NHS FOUNDATION TRUST,Suspected urological malignancies (excluding testicular),269,166,103
Sep-23,UNIVERSITY HOSPITALS SUSSEX NHS FOUNDATION TRUST,Suspected upper gastrointestinal cancer,289,195,94
Sep-23,FRIMLEY HEALTH NHS FOUNDATION TRUST,Suspected upper gastrointestinal cancer,199,131,68
Sep-23,ROYAL SURREY COUNTY HOSPITAL NHS FOUNDATION TRUST,Suspected urological malignancies (excluding testicular),79,73,6
Sep-23,ASHFORD AND ST PETER'S HOSPITALS NHS FOUNDATION TRUST,Suspected urological malignancies (excluding testicular),113,74,39
Sep-23,UNIVERSITY HOSPITALS SUSSEX NHS FOUNDATION TRUST,Suspected urological malignancies (excluding testicular),442,204,238